1;Urusan Wajib Pelayanan Dasar;83752105480;297259263885;248088807423;629100176788
01.01;Pendidikan;50382594480;131216100785;80348668000;261947363265
1.01 . 1.01.01;DINAS PENDIDIKAN, KEBUDAYAAN, PEMUDA DAN OLAHRAGA;50382594480;131216100785;80348668000;261947363265
1.01 . 1.01.01 . 01;Program Pelayanan Administrasi, Sarana Prasarana dan SDM Aparatur;3638994480;1701617785;310000000;5650612265
1.01 . 1.01.01 . 01 . 01;Kegiatan Pelayanan Jasa Administrasi Perkantoran Dikbudpora;3638994480;1129488000;0;4768482480
1.01 . 1.01.01 . 01 . 02;Kegiatan Pelayanan Jasa Administrasi Perkantoran (UPTD-Museum Daerah);0;100000000;0;100000000
1.01 . 1.01.01 . 01 . 03;Kegiatan Peningkatan Sarana dan Prasarana Perkantoran Dikbudpora;0;255550000;205000000;460550000
1.01 . 1.01.01 . 01 . 04;Kegiatan Peningkatan Sarana dan Prasarana Perkantoran (UPTD Museum);0;0;105000000;105000000
1.01 . 1.01.01 . 01 . 05;Kegiatan Peningkatan Kapasitas Sumber Daya Aparatur (Pendidikan dan Pelatihan, Bimbingan Teknis dan Sosialisasi) Provinsi Gorontalo;0;106350000;0;106350000
1.01 . 1.01.01 . 01 . 06;Kegiatan Peningkatan Sumber Daya Aparatur (Pendidikan, Pelatihan, Bimtek dan Sosialisasi) UPTD Museum;0;110229785;0;110229785
1.01 . 1.01.01 . 02;Program Perencanaan, Evaluasi, Monitoring dan Pelaporan;0;1937295000;0;1937295000
1.01 . 1.01.01 . 02 . 01;Kegiatan Perencanaan, Pendataan, Koordinasi dan Pelaporan;0;1760215000;0;1760215000
1.01 . 1.01.01 . 02 . 02;Kegiatan Penatausahaan dan Penyusunan Laporan Keuangan;0;177080000;0;177080000
1.01 . 1.01.01 . 15;Program Pendidikan Menengah dan Pendidikan Khusus;0;7395418000;23460000000;30855418000
1.01 . 1.01.01 . 15 . 03;Kegiatan Revitalisasi /penambahan Ruang Kelas Baru (RKB) SMA/SLB;0;117000000;2000000000;2117000000
1.01 . 1.01.01 . 15 . 04;Kegiatan Pembangunan fasilitas penunjang lainnya SMA/SLB;0;0;600000000;600000000
1.01 . 1.01.01 . 15 . 05;Kegiatan Revitalisasi /penambahan Ruang Kelas Baru (RKB) SMK;0;76760000;1050000000;1126760000
1.01 . 1.01.01 . 15 . 06;Kegiatan Penyediaan Media Pembelajaran/ Alat praktek dan alat peraga siswa SMA/SLB;0;1136428000;3185000000;4321428000
1.01 . 1.01.01 . 15 . 07;Kegiatan Penyediaan Media Pembelajaran/ Alat praktek dan alat peraga siswa SMK;0;832032000;3825000000;4657032000
1.01 . 1.01.01 . 15 . 08;Kegiatan Penyediaan meubelair SMA/SLB;0;0;8600000000;8600000000
1.01 . 1.01.01 . 15 . 09;Kegiatan Penyediaan meubelair SMK;0;80056000;3400000000;3480056000
1.01 . 1.01.01 . 15 . 10;Kegiatan Pelatihan Proktor Ujian Sekolah/Madrasah;0;238324000;0;238324000
1.01 . 1.01.01 . 15 . 11;Kegiatan Pembinaan Minat Bakat/Kreatifitas/Prestasi Siswa SMA/SLB;0;818518000;0;818518000
1.01 . 1.01.01 . 15 . 12;Kegiatan Pembinaan Minat Bakat/Kreatifitas/Prestasi Siswa SMK;0;730400000;0;730400000
1.01 . 1.01.01 . 15 . 13;Kegiatan Pembangunan Ruang Praktek/ Laboratorium SMA/SLB;0;0;200000000;200000000
1.01 . 1.01.01 . 15 . 14;Kegiatan Pembangunan Ruang Praktek/ Laboratorium/ display SMK;0;65900000;600000000;665900000
1.01 . 1.01.01 . 15 . 23;Kegiatan Boarding School SMA/SLB;0;2500000000;0;2500000000
1.01 . 1.01.01 . 15 . 24;Kegiatan Vokasi/Sertifikasi Kompetensi Siswa SMK;0;800000000;0;800000000
1.01 . 1.01.01 . 16;Program Pembinaan Guru dan Tenaga Kependidikan;46743600000;993900000;0;47737500000
1.01 . 1.01.01 . 16 . 02;Kegiatan Pelaksanaan Supervisi Manajerial dan Akademik;0;300000000;0;300000000
1.01 . 1.01.01 . 16 . 07;Kegiatan Pelaksanaan Seleksi Guru dan Tenaga Kependidikan Berprestasi dan Berdedikasi;0;562500000;0;562500000
1.01 . 1.01.01 . 16 . 08;Kegiatan Pemberian Beasiswa Bagi Guru dan Tenaga Kependidikan;0;75000000;0;75000000
1.01 . 1.01.01 . 16 . 09;Kegiatan Pemberian Insentif/Tunjangan bagi guru dan tenaga kependidikan Non PNS;46743600000;56400000;0;46800000000
1.01 . 1.01.01 . 17;Program Pendidikan Untuk Rakyat (PRODIRA);0;9118720000;0;9118720000
1.01 . 1.01.01 . 17 . 01;Kegiatan Pemberian Bantuan Studi Bagi Mahasiswa Miskin/ Berprestasi;0;8968720000;0;8968720000
1.01 . 1.01.01 . 17 . 02;Kegiatan Lomba PAUDNI/Dikmas/ Dikdas Tingkat Provinsi;0;150000000;0;150000000
1.01 . 1.01.01 . 82;BOS Reguler SMA/SMK DIKSUS Negeri (DAK Non Fisik);0;110069150000;0;110069150000
1.01 . 1.01.01 . 82 . 01;BOS Reguler SMA/SMK/DIKSUS Negeri (DAK Non Fisik);0;66662600000;0;66662600000
1.01 . 1.01.01 . 82 . 02;BOS Afirmasi (DAK Non Fisik);0;27928000000;0;27928000000
1.01 . 1.01.01 . 82 . 03;BOS Kinerja (DAK Non Fisik);0;15478550000;0;15478550000
1.01 . 1.01.01 . 83;Program Perluasan Akses Pendidikan Menengah dan Pendidikan Khusus (DAK Fisik);0;0;56578668000;56578668000
1.01 . 1.01.01 . 83 . 01;Peningkatan Akses Layanan SMA (DAK Fisik Reguler);0;0;32017835000;32017835000
1.01 . 1.01.01 . 83 . 02;Peningkatan Akses Layanan SMA (DAK Fisik Afirmasi);0;0;1110733000;1110733000
1.01 . 1.01.01 . 83 . 03;Peningkatan Akses Layanan SMK (DAK Fisik Penugasan);0;0;22343080000;22343080000
1.01 . 1.01.01 . 83 . 04;Peningkatan Akses Layanan SLB (DAK Fisik Reguler);0;0;1107020000;1107020000
01.02;Kesehatan;18856060000;97325053788;8115514000;124296627788
1.02 . 1.02.01;DINAS KESEHATAN;18856060000;97325053788;8115514000;124296627788
1.02 . 1.02.01 . 01;Program Peningkatan Manajemen Administrasi, Sarana dan Prasarana serta Sumber Daya Aparatur;201960000;9342970531;2990182000;12535112531
1.02 . 1.02.01 . 01 . 01;Pelayanan Jasa Administrasi Perkantoran;141240000;1684093000;0;1825333000
1.02 . 1.02.01 . 01 . 03;Pelayanan Jasa Administrasi Perkantoran UPTD Labkesda;60720000;331266000;0;391986000
1.02 . 1.02.01 . 01 . 04;Pelayanan Jasa Administrasi Perkantoran RSUD Ainun Habibie;0;5244039000;0;5244039000
1.02 . 1.02.01 . 01 . 05;Peningkatan Sarana dan Prasarana Dikes;0;488448000;399282000;887730000
1.02 . 1.02.01 . 01 . 07;Peningkatan Sarana dan Prasarana UPTD Labkesda;0;677000000;405500000;1082500000
1.02 . 1.02.01 . 01 . 08;Peningkatan Sarana dan Prasarana RSUD Ainun Habibie;0;0;2185400000;2185400000
1.02 . 1.02.01 . 01 . 09;Peningkatan Kapasitas SDM Aparatur Dikes;0;343320000;0;343320000
1.02 . 1.02.01 . 01 . 11;Peningkatan Kapasitas SDM Aparatur UPTD Labkesda;0;83750000;0;83750000
1.02 . 1.02.01 . 01 . 12;Peningkatan Kapasitas SDM Aparatur RSUD Ainun Habibie;0;491054531;0;491054531
1.02 . 1.02.01 . 02;Perencanaan, Evaluasi dan Pelaporan;320760000;773436205;0;1094196205
1.02 . 1.02.01 . 02 . 01;Rapat Kerja Kesehatan Daerah;0;201290000;0;201290000
1.02 . 1.02.01 . 02 . 02;Perencanaan, Evaluasi dan Pelaporan;118800000;191761500;0;310561500
1.02 . 1.02.01 . 02 . 03;Diseminasi Isu-Isu Strategis Kesehatan dan Hasil Riset Kesehatan yang dilaksanakan di Provinsi Gorontalo;0;225000000;0;225000000
1.02 . 1.02.01 . 02 . 04;Pemutakhiran Data Profil Kesehatan;88440000;82964705;0;171404705
1.02 . 1.02.01 . 02 . 05;Penatausahaan dan Penyusunan Laporan Keuangan;113520000;72420000;0;185940000
1.02 . 1.02.01 . 03;Program Kesehatan Keluarga dan gizi masyarakat;232320000;451342750;0;683662750
1.02 . 1.02.01 . 03 . 01;Pendampingan Ibu Hamil Beresiko Selama Masa Kehamilan;146520000;70630000;0;217150000
1.02 . 1.02.01 . 03 . 02;Penanganan Kegawat Daruratan Ibu dan Bayi;30360000;104270000;0;134630000
1.02 . 1.02.01 . 03 . 04;Pengadaan PMT Bumil KEK dan Balita Kurang Gizi;55440000;276442750;0;331882750
1.02 . 1.02.01 . 04;Promosi Kesehatan dan Pemberdayaan Masyarakat;158640000;377076532;0;535716532
1.02 . 1.02.01 . 04 . 02;Penyebarluasan informasi PHBS dan Isu-Isu Strategis Kesehatan;97920000;142950000;0;240870000
1.02 . 1.02.01 . 04 . 03;Pengawasan dan Penyehatan Lingkungan;60720000;234126532;0;294846532
1.02 . 1.02.01 . 05;Pencegahan, Pengendalian Penyakit dan Masalah Kesehatan Jiwa;242880000;1051966000;0;1294846000
1.02 . 1.02.01 . 05 . 01;Penemuan, Penanganan dan Pembinaan Tata Laksana Penyakit Menular;89760000;216720000;0;306480000
1.02 . 1.02.01 . 05 . 03;Surveilans PD3I dan Monev Pelaksanaan Program imunisasi;66000000;80760000;0;146760000
1.02 . 1.02.01 . 05 . 04;Penyeledikan Epidemiologi KLB/Wabah Penyakit;58080000;197130000;0;255210000
1.02 . 1.02.01 . 05 . 05;Monev Pelaksanaan Istitoah Kesehatan jemaah Haji;0;97600000;0;97600000
1.02 . 1.02.01 . 05 . 06;Deteksi Dini Faktor Resiko PTM;29040000;253615000;0;282655000
1.02 . 1.02.01 . 05 . 07;Sosialisasi  Bahaya Rokok dan Napza;0;109033000;0;109033000
1.02 . 1.02.01 . 05 . 08;Monev Program Masalah Kesehatan Jiwa;0;97108000;0;97108000
1.02 . 1.02.01 . 06;Peningkatan Mutu Fasyankes;237120000;2001035000;50180000;2288335000
1.02 . 1.02.01 . 06 . 01;Penguatan kapasitas Program Pelayanan kesehatan Primer;60720000;803170000;0;863890000
1.02 . 1.02.01 . 06 . 04;Pencegahan dan Penanggulangan Resiko Akibat Krisis Kesehatan;58080000;569855000;50180000;678115000
1.02 . 1.02.01 . 06 . 05;Rakor Peningkatan Mutu dan Akses Pelayanan Kesehatan di FKTL;118320000;243700000;0;362020000
1.02 . 1.02.01 . 06 . 08;Peningakatan Pelayanan Laboratorium Kesehatan Daerah;0;289900000;0;289900000
1.02 . 1.02.01 . 06 . 09;Orientasi Program Kesehatan Kerja dan Olahraga;0;94410000;0;94410000
1.02 . 1.02.01 . 07;Peningkatan Sarana Prasarana dan Pemeliharaan RS;0;979387500;0;979387500
1.02 . 1.02.01 . 07 . 02;Pemeliharaan Saspras RS;0;979387500;0;979387500
1.02 . 1.02.01 . 08;Kemitraan dan Peningkatan Pelayanan Medik RS;16412040000;17441445651;0;33853485651
1.02 . 1.02.01 . 08 . 01;Kemitraan Peningkatan Kualitas Dokter dan Paramedis;16412040000;1426436101;0;17838476101
1.02 . 1.02.01 . 08 . 02;Pelayanan Medik RSUD d. Hasri Ainun Habibie;0;16015009550;0;16015009550
1.02 . 1.02.01 . 09;Jaminan Pemeliharaan Kesehatan;740520000;55446933219;5115000;56192568219
1.02 . 1.02.01 . 09 . 01;Penanganan Keluhan JKN;505560000;255740000;0;761300000
1.02 . 1.02.01 . 09 . 02;Kebijakan Teknis Program Jamkesta;0;225000000;0;225000000
1.02 . 1.02.01 . 09 . 03;Jamkesta;0;52960123219;0;52960123219
1.02 . 1.02.01 . 09 . 04;Kerjasama Pelayanan Pasien Rujukan Ke Luar Daerah Dengan RS di Luar Provinsi Gorontalo;174240000;1137160000;0;1311400000
1.02 . 1.02.01 . 09 . 05;Pelayanan Pasien Miskin/Tidak Mampu;60720000;868910000;5115000;934745000
1.02 . 1.02.01 . 10;Pengembangan dan Pemberdayaan Sumber Daya Kesehatan;160660000;824183000;0;984843000
1.02 . 1.02.01 . 10 . 01;Pemetaan, Perencanaan dan Distribusi Nakes di FKTP dan FKTL Tingkat Provinsi;69720000;129960000;0;199680000
1.02 . 1.02.01 . 10 . 02;Penilaian Nakes Teladan Tingkat Provinsi;0;147352000;0;147352000
1.02 . 1.02.01 . 10 . 03;Orientasi Pengelolaan Obat dan Vaksin di Instalasi Farmasi Kab/Kota;60580000;316971000;0;377551000
1.02 . 1.02.01 . 10 . 07;Monitoring dan Evaluasi Sarana Produksi, Distribusi  Sediaan Farmasi, Alat Kesehatan Yang Terjamin Khasiat Mutu dan Keamanan;30360000;229900000;0;260260000
1.02 . 1.02.01 . 11;Peningkatan Layanan KB;149160000;171783000;0;320943000
1.02 . 1.02.01 . 11 . 01;Pelaksanaan Grand Design Kependudukan Dalam Pencapaian Cakupan KB Aktif;30360000;44713000;0;75073000
1.02 . 1.02.01 . 11 . 02;Orientasi KB Pasca Persalinan;58080000;93660000;0;151740000
1.02 . 1.02.01 . 11 . 03;Orientasi Fasilitator Kesehatan Repreoduksi Remaja;60720000;33410000;0;94130000
1.02 . 1.02.01 . 12;Dana Alokasi Khusus (DAK) Bidang Kesehatan;0;8463494400;5070037000;13533531400
1.02 . 1.02.01 . 12 . 01;Pelayanan Kesehatan Dasar (DAK Fisik Regular);0;0;816999000;816999000
1.02 . 1.02.01 . 12 . 02;Pelayanan Kesehatan Rujukan (DAK Fisik Regular);0;0;3993872000;3993872000
1.02 . 1.02.01 . 12 . 03;Pelayanan Kesehatan Kefarmasian (DAK Fisik Regular);0;0;259166000;259166000
1.02 . 1.02.01 . 12 . 05;Bantuan Operasional Kesehatan (BOK) (DAK Non Fisik);0;7526508000;0;7526508000
1.02 . 1.02.01 . 12 . 06;Penguatan Intervensi Stunting (DAK Fisik Penugasan);0;936986400;0;936986400
01.03;Pekerjaan Umum dan Penataan Ruang;7715036000;24440427848;156366718415;188522182263
1.03 . 1.03.01;DINAS PEKERJAAN UMUM DAN PENATAAN RUANG;7715036000;24440427848;156366718415;188522182263
1.03 . 1.03.01 . 01;Program Peningkatan Pelayanan Administrasi, Sarana Prasarana dan SDM Aparatur;2310360000;3913229541;828804915;7052394456
1.03 . 1.03.01 . 01 . 01;Pelayanan Jasa Administrasi Perkantoran;437100000;1934279000;0;2371379000
1.03 . 1.03.01 . 01 . 03;Pelayanan Jasa Administrasi Perkantoran UPTD TPA Talumelito;0;153280000;0;153280000
1.03 . 1.03.01 . 01 . 05;Peningkatan Sarana dan Prasarana Perkantoran;0;250000000;656482000;906482000
1.03 . 1.03.01 . 01 . 07;Peningkatan Sarana dan Prasarana Perkantoran UPTD TPA Talumelito;1078620000;744540000;63500000;1886660000
1.03 . 1.03.01 . 01 . 09;Peningkatan Kapasitas SDM Aparatur;425040000;360460000;0;785500000
1.03 . 1.03.01 . 01 . 13;Pelayanan Jasa Administrasi Perkantoran (UPTD Laboratorium);369600000;333970000;10000000;713570000
1.03 . 1.03.01 . 01 . 14;Peningkatan Sarana dan Prasarana (UPTD Laboratorium);0;136700541;98822915;235523456
1.03 . 1.03.01 . 02;Program Peningkatan Perencanaan, Monitoring, Evaluasi dan Pelaporan;225720000;1302782000;0;1528502000
1.03 . 1.03.01 . 02 . 01;Perencanaan, Koordinasi, Monitoring Evaluasi dan Pelaporan;225720000;374280000;0;600000000
1.03 . 1.03.01 . 02 . 02;Penatausahaan dan Pelaporan Keuangan SKPD;0;200000000;0;200000000
1.03 . 1.03.01 . 02 . 03;Peningkatan Kinerja Penyusunan Program;0;728502000;0;728502000
1.03 . 1.03.01 . 29;Program Pengembangan Kawasan Strategis;0;2430234946;11975000000;14405234946
1.03 . 1.03.01 . 29 . 01;Pembangunan/Peningkatan Infrastruktur Permukiman;0;87450000;1000000000;1087450000
1.03 . 1.03.01 . 29 . 02;Pembangunan Prasarana dan Sarana Gedung Perkantoran;0;239984946;10975000000;11214984946
1.03 . 1.03.01 . 29 . 04;Pembangunan Sarana dan Prasarana Fasilitas Layanan Umum;0;437910000;0;437910000
1.03 . 1.03.01 . 29 . 06;Koordinasi Kegiatan Pengembangan Kawasan Strategis;0;210813750;0;210813750
1.03 . 1.03.01 . 29 . 07;Penyusunan Dokumen Perencanaan, Pengawasan dan Evaluasi Pengembangan Wilayah Stategis dan Cepat Tumbuh;0;1454076250;0;1454076250
1.03 . 1.03.01 . 31;Program Pembinaan Jasa Konstruksi;283920000;733330000;0;1017250000
1.03 . 1.03.01 . 31 . 01;Teknis Jasa Konstruksi;283920000;90170000;0;374090000
1.03 . 1.03.01 . 31 . 02;Bina Jasa Konstruksi;0;180900000;0;180900000
1.03 . 1.03.01 . 31 . 03;Kerjasama dan Pemberdayaan Masyarakat Usaha Jasa Konstruksi;0;462260000;0;462260000
1.03 . 1.03.01 . 33;Program Penyelenggaraan Jalan dan Jembatan;1148700000;6434101998;60672411000;68255212998
1.03 . 1.03.01 . 33 . 01;Pembangunan Jalan Provinsi;0;233480000;24545850000;24779330000
1.03 . 1.03.01 . 33 . 03;Pembangunan Jembatan Provinsi;0;64750000;36126561000;36191311000
1.03 . 1.03.01 . 33 . 05;Penyusunan Dokumen Perencanaan dan Pengawasan Pembangunan Jalan dan Jembatan;0;3569136998;0;3569136998
1.03 . 1.03.01 . 33 . 06;Koordinasi Pengembangan Jaringan Jalan;0;298775000;0;298775000
1.03 . 1.03.01 . 33 . 08;Pemeliharaan/Peningkatan Berkala Jalan Provinsi;0;201110000;0;201110000
1.03 . 1.03.01 . 33 . 09;Pemeliharaan Rutin Jalan Provinsi;1148700000;1838500000;0;2987200000
1.03 . 1.03.01 . 33 . 10;Pemeliharaan Jembatan Provinsi;0;228350000;0;228350000
1.03 . 1.03.01 . 34;Program Penyediaan Lahan untuk Kepentingan Umum;570960000;2954400000;34505667500;38031027500
1.03 . 1.03.01 . 34 . 01;Pelaksanaan Pengadaan Tanah;570960000;2954400000;34505667500;38031027500
1.03 . 1.03.01 . 35;Program Pengembangan Kinerja Air Minum dan Sanitasi;876576000;1778364901;0;2654940901
1.03 . 1.03.01 . 35 . 01;Penyusunan Dokumen Perencanaan Pengawasan dan Evaluasi Pengelolaan Air Minum dan Air Limbah;0;529869844;0;529869844
1.03 . 1.03.01 . 35 . 02;Koordinasi Kegiatan Pengelolaan Air Minum dan Sanitasi;876576000;1248495057;0;2125071057
1.03 . 1.03.01 . 70;Program Pengembangan dan Rehabilitasi Jaringan Irigasi, Air Tanah dan Rawa & Tambak;2298800000;1971696000;0;4270496000
1.03 . 1.03.01 . 70 . 01;Penyusunan Dokumen Perencanaan serta Pengawasan Teknis Irigasi;0;347756000;0;347756000
1.03 . 1.03.01 . 70 . 02;Optimalisasi Fungsi Jaringan Irigasi Yang Telah Dibangun;2298800000;1513914000;0;3812714000
1.03 . 1.03.01 . 70 . 03;Koordinasi dan Sinkronisasi Sumber Daya Air;0;110026000;0;110026000
1.03 . 1.03.01 . 71;Program Pengendali Banjir;0;1823947231;2750000000;4573947231
1.03 . 1.03.01 . 71 . 01;Penyusunan Dokumen Perencanaan serta Pengawasan Teknis Pengendalian Daya Rusak Air;0;652397231;0;652397231
1.03 . 1.03.01 . 71 . 02;Pembangunan Pengamanan Badan Sungai dan Tebing;0;1103300000;1750000000;2853300000
1.03 . 1.03.01 . 71 . 03;Pembangunan Prasarana Pengaman Pantai;0;68250000;1000000000;1068250000
1.03 . 1.03.01 . 72;Program Perencanaan Pemanfaatan dan Pengendalian Tata Ruang;0;876047231;0;876047231
1.03 . 1.03.01 . 72 . 02;Pengendalian dan Evaluasi Pemanfaatan Ruang;0;310800000;0;310800000
1.03 . 1.03.01 . 72 . 04;Koordinasi Pemanfaatan dan Legalisasi Rencana Umum dan Rencana Rinci Tata Ruang;0;565247231;0;565247231
1.03 . 1.03.01 . 74;Program Pengembangan Kinerja Pengelolaan Sampah;0;78950000;0;78950000
1.03 . 1.03.01 . 74 . 01;Peningkatan Kapasitas dan Peran serta Masyarakat dalam Pengelolaan Persampahan;0;78950000;0;78950000
1.03 . 1.03.01 . 75;Program Pembangunan Jalan dan Jembatan (DAK);0;0;42884442000;42884442000
1.03 . 1.03.01 . 75 . 01;Pemeliharaan/Peningkatan Berkala Jalan Provinsi (DAK);0;0;42884442000;42884442000
1.03 . 1.03.01 . 76;Program Pengembangan dan Rehabilitasi Jaringan Irigasi, Air Tanah dan Rawa & Tambak (DAK);0;143344000;2750393000;2893737000
1.03 . 1.03.01 . 76 . 01;Rehabilitasi/Peningkatan  Jaringan Irigasi (DAK);0;143344000;2750393000;2893737000
01.04;Perumahan Rakyat dan Kawasan Pemukiman;1169880000;29330055044;1809040000;32308975044
1.04 . 1.04.01;DINAS PERUMAHAN RAKYAT DAN KAWASAN PERMUKIMAN;1169880000;29330055044;1809040000;32308975044
1.04 . 1.04.01 . 01;Program Peningkatan Pelayanan Administrasi, Sarana Prasarana dan SDM Aparatur;676200000;980630000;113000000;1769830000
1.04 . 1.04.01 . 01 . 01;Pelayanan Jasa Administrasi Perkantoran;676200000;608568000;0;1284768000
1.04 . 1.04.01 . 01 . 02;Peningkatan Sarana dan Prasarana Perkantoran;0;218746000;113000000;331746000
1.04 . 1.04.01 . 01 . 03;Peningkatan Kapasitas SDM Aparatur;0;153316000;0;153316000
1.04 . 1.04.01 . 02;Peningkatan Perencanaan, Monitoring, Evaluasi dan Pelaporan;0;823404870;0;823404870
1.04 . 1.04.01 . 02 . 02;Perencanaan, Koordinasi, Monitoring dan Evaluasi;0;723404870;0;723404870
1.04 . 1.04.01 . 02 . 03;Penatausahaan dan Penyusunan Laporan Keuangan SKPD;0;100000000;0;100000000
1.04 . 1.04.01 . 21;Program Penyediaan Rumah Hunian Layak bagi masyarakat Miskin, Korban Bencana Provinsi dan dampak Pembangunan Provinsi;410520000;26344855000;0;26755375000
1.04 . 1.04.01 . 21 . 01;Penyusunan Perencanaan Teknis, Perumusan Kebijakan, Pengendalian dan evaluasi Pelaksanaan Bidang Perumahan;0;747165000;0;747165000
1.04 . 1.04.01 . 21 . 02;Penyediaan Rumah Hunian layak bagi Masyarakat Miskin;410520000;24902840000;0;25313360000
1.04 . 1.04.01 . 21 . 03;Penyediaan dan rehab  Rumah Hunian Layak bagi Korban Bencana Alam Provinsi dan dampak pembangunan Provinsi;0;201200000;0;201200000
1.04 . 1.04.01 . 21 . 04;Koordinasi  , Sinkronisasi dan evaluasi pelaksanaan bidang perumahan;0;493650000;0;493650000
1.04 . 1.04.01 . 22;Program Peningkatan Kawasan Permukiman;83160000;1181165174;1696040000;2960365174
1.04 . 1.04.01 . 22 . 01;Pembangunan/peningkatan Sarana dan Prasarana Kawasan Permukiman  Provinsi;83160000;175550000;1696040000;1954750000
1.04 . 1.04.01 . 22 . 02;Koordinasi dan Sinkronisasi pelaksanaan bidang permukiman;0;425315000;0;425315000
1.04 . 1.04.01 . 22 . 03;Perencanaan,Pengawasan, Pengendalian dan evaluasi  prasarana dan sarana kawasan permukiman;0;329090000;0;329090000
1.04 . 1.04.01 . 22 . 04;Advokasi dan Pembinaan masyarakat di kawasan permukiman kumuh provinsi;0;251210174;0;251210174
01.05;Ketentraman dan Ketertiban Umum serta Perlindungan Masyarakat;3583630000;5469609428;130920000;9184159428
1.05 . 1.05.01;BADAN KESATUAN BANGSA DAN POLITIK;531630000;4454880000;130920000;5117430000
1.05 . 1.05.01 . 01;Peningkatan Pelayanan Administrasi, Sarana Prasarana dan SDM Aparatur;77400000;668600000;130920000;876920000
1.05 . 1.05.01 . 01 . 01;Pelayanan Jasa Administrasi Perkantoran;77400000;383862000;0;461262000
1.05 . 1.05.01 . 01 . 02;Peningkatan Sarana dan Prasarana Perkantoran;0;167208000;130920000;298128000
1.05 . 1.05.01 . 01 . 03;Peningkatan Kapasitas SDM Aparatur;0;117530000;0;117530000
1.05 . 1.05.01 . 02;Peningkatan Perencanaan, Monitoring, Evaluasi dan Pelaporan;60720000;249280000;0;310000000
1.05 . 1.05.01 . 02 . 01;Perencanaan, Koordinasi, Monitoring dan Evaluasi;30360000;169640000;0;200000000
1.05 . 1.05.01 . 02 . 02;Penatausahaan dan Penyusunan Laporan Keuangan;30360000;79640000;0;110000000
1.05 . 1.05.01 . 15;Program Peningkatan Keamanan dan Kenyamanan Lingkungan;182160000;1003370000;0;1185530000
1.05 . 1.05.01 . 15 . 12;Rapat Kerjasama Intelijen dan Pencegahan Konflik Sosial Terorisme;60720000;133280000;0;194000000
1.05 . 1.05.01 . 15 . 13;Koordinasi Dan Evaluasi Rencana Aksi Penanganan Konflik Sosial Provinsi Gorontalo;60720000;139280000;0;200000000
1.05 . 1.05.01 . 15 . 14;Forum Koordinasi Pimpinan Daerah (FORKOPIMDA);30360000;469640000;0;500000000
1.05 . 1.05.01 . 15 . 15;Rapat Kerja dan Pengawasan Orang Asing;0;82910000;0;82910000
1.05 . 1.05.01 . 15 . 16;Rapat Forum Kewaspadaan Dini Masyarakat ( FKDM);30360000;69640000;0;100000000
1.05 . 1.05.01 . 15 . 17;Pelatihan Dasar-Dasar Intelejen Bagi Aparat Badan KESBANGPOL Prov, Kab/Kota;0;50000000;0;50000000
1.05 . 1.05.01 . 15 . 18;Fasilitasi Cegah Dini Potensi Konflik;0;58620000;0;58620000
1.05 . 1.05.01 . 16;Program Pendidikan Politik Masyarakat;125550000;1218330000;0;1343880000
1.05 . 1.05.01 . 16 . 01;Forum Diskusi;0;100000000;0;100000000
1.05 . 1.05.01 . 16 . 02;Monitoring dan Pemantauan Tahapan PILKADA Gubernur/Bupati/Walikota;60720000;339280000;0;400000000
1.05 . 1.05.01 . 16 . 03;Forum Koordinasi Peningkatan Partisipasi Indeks Demokrasi;0;100000000;0;100000000
1.05 . 1.05.01 . 16 . 04;Kajian Implementasi Kebijakan-Kebijakan Pemerintah Provinsi Gorontalo;0;150000000;0;150000000
1.05 . 1.05.01 . 16 . 05;Pendidikan Politik Bagi Masyarakat dan Partai Politik;58080000;435800000;0;493880000
1.05 . 1.05.01 . 16 . 06;Bimtek Pemanfaatan dan Pertangungawaban Bantuan Keuangan bagi Kesbangpol Kab./Kota dan Partai Politik dan Verifikasi Bantuan Keuangan Parpol;6750000;93250000;0;100000000
1.05 . 1.05.01 . 18;Program Kemitraan Pengembangan Wawasan Kebangsaan;30360000;520740000;0;551100000
1.05 . 1.05.01 . 18 . 04;Rapat Koordinasi Forum Pembauran Kebangsaan (FPK);0;201100000;0;201100000
1.05 . 1.05.01 . 18 . 05;Pemantapan Wawasan Kebangsaan, Cinta Tanah Air, Kesadaran Bela Negara dan Pembaruan Generasi Muda;30360000;219640000;0;250000000
1.05 . 1.05.01 . 18 . 06;Monitoring & Evaluasi Aktifitas Perkembangan Suku, Etnis, Budaya Bangsa;0;100000000;0;100000000
1.05 . 1.05.01 . 23;Program Peningkatan Ketahanan Sosial dan Budaya Masyarakat;27720000;572280000;0;600000000
1.05 . 1.05.01 . 23 . 02;Forum Kerukunan Umat Beragama (FKUB);0;172580000;0;172580000
1.05 . 1.05.01 . 23 . 05;Penguatan dan Verifikasi Kelembagaan LSM/Ormas;0;127420000;0;127420000
1.05 . 1.05.01 . 23 . 06;Dialog dan Sosialisasi P4GN (Pencegahan Pemberantasan Penyalagunaan dan Peredaran Gelap Narkoba);27720000;172280000;0;200000000
1.05 . 1.05.01 . 23 . 07;Fasilitasi Pencegahan Penyakit Masyarakat;0;100000000;0;100000000
1.05 . 1.05.01 . 24;Program Peningkatan Ketahanan Ekonomi;27720000;222280000;0;250000000
1.05 . 1.05.01 . 24 . 02;Cegah Dini Terhadap Praktek Penyalagunaan, Penimbunan Sembako dan Kebutuhan Masyarakat Lainnya;27720000;222280000;0;250000000
1.05 . 4.01.09;SATUAN POLISI PAMONG PRAJA DAN PERLINDUNGAN MASYARAKAT;3052000000;1014729428;0;4066729428
1.05 . 4.01.09 . 30;Pengamanan dan Pelayanan Kedinasan Kepala Daerah dan Wakil Kepala Daerah serta Tamu VIP/VVIP;2512000000;268629513;0;2780629513
1.05 . 4.01.09 . 30 . 01;Pengamanan dan Pelayanan Kedinasan Kepala Daerah dan Wakil Kepala Daerah serta Para Tamu VIP/VVIP;2022400000;130428373;0;2152828373
1.05 . 4.01.09 . 30 . 02;Kegiatan Rapat Koordinasi Trantibum;0;40729081;0;40729081
1.05 . 4.01.09 . 30 . 03;Pengamanan dan Pengendalian Aksi Unjuk Rasa dan hari-hari Besar Keagamaan;489600000;51912329;0;541512329
1.05 . 4.01.09 . 30 . 04;Patroli tempat-tempat Rawan Trantibum, Pam Obvit, Rumah-Rumah Jabatan;0;45559730;0;45559730
1.05 . 4.01.09 . 31;Penegakkan Peraturan Daerah dan Peraturan Kepala Daerah serta peningkatan Kualitas Produk Hukum Daerah;74400000;397329928;0;471729928
1.05 . 4.01.09 . 31 . 01;Kegiatan Penegakkan dan Pengawasan Peraturan Daerah dan Peraturan Kepala Daerah;0;79213006;0;79213006
1.05 . 4.01.09 . 31 . 02;Operasi yustisi dan non yustisi untuk Penyakit Masyarakat (PEKAT);74400000;137517880;0;211917880
1.05 . 4.01.09 . 31 . 03;Pembinaan dan Penyuluhan Peraturan Daerah dan Peraturan Kepala Daerah;0;67975161;0;67975161
1.05 . 4.01.09 . 31 . 04;Rapat Koordinasi PPNS;0;112623881;0;112623881
1.05 . 4.01.09 . 32;Peningkatan Keamanan dan Kenyamanan Lungkungan serta Perlindungan Masyarakat;123600000;280681276;0;404281276
1.05 . 4.01.09 . 32 . 01;Penguatan Perlindungan Masyarakat dalam Penanganan Penyandang Masalah Pengangguran, Gelandangan dan Orang Terlantar (PGOT);49200000;53942801;0;103142801
1.05 . 4.01.09 . 32 . 02;Peningkatan Koordinasi dalam membangun Kemitraan Perlindungan Masyarakat dengan Kab/Kota;0;46611544;0;46611544
1.05 . 4.01.09 . 32 . 03;Peringatan Dini/Deteksi Dini;0;51273028;0;51273028
1.05 . 4.01.09 . 32 . 05;Apel Siaga Satpol PP. Linmas dan Kebakaran Kab/Kota Se Provinsi Gorontalo;0;53238043;0;53238043
1.05 . 4.01.09 . 32 . 06;Penguatan Mental dan Fisik Aparatur Satpol PP, Linmas dan Kebakaran;74400000;75615860;0;150015860
1.05 . 4.01.09 . 33;Peningkatan Pelayanan Pemadam Kebakaran;342000000;68088711;0;410088711
1.05 . 4.01.09 . 33 . 01;Kegiatan Fasilitasi Bahaya Bencana Kebakaran dan Bencana  lainnya;342000000;68088711;0;410088711
01.06;Sosial;2044905000;9478016992;1317947008;12840869000
1.06 . 1.06.01;DINAS SOSIAL, PEMBERDAYAAN PEREMPUAN DAN PERLINDUNGAN ANAK;1582480000;5754051792;522337208;7858869000
1.06 . 1.06.01 . 01;Pelayanan Administrasi, Sarana Prasarana dan SDM Aparatur;55440000;1275199292;522337208;1852976500
1.06 . 1.06.01 . 01 . 01;Pelayanan Jasa Administrasi Perkantoran;55440000;553560000;0;609000000
1.06 . 1.06.01 . 01 . 02;Peningkatan Sarana dan Prasarana Perkantoran;0;589374292;522337208;1111711500
1.06 . 1.06.01 . 01 . 03;Peningkatan Kapasitas SDM Aparatur;0;132265000;0;132265000
1.06 . 1.06.01 . 02;Peningkatan Perencanaan, Evaluasi dan Pelaporan;194040000;461983500;0;656023500
1.06 . 1.06.01 . 02 . 01;Penyusunan Anggaran dan Laporan Keuangan SKPD;83160000;36840000;0;120000000
1.06 . 1.06.01 . 02 . 02;Perencanaan, Koordinasi, Monitoring Evaluasi dan Pelaporan;110880000;425143500;0;536023500
1.06 . 1.06.01 . 15;Pemberdayaan Sosial;187320000;1657149000;0;1844469000
1.06 . 1.06.01 . 15 . 01;Kepahlawanan, Keperintisan dan Kesetiakawanan Sosial dan Restorasi Sosial (K3RS);67440000;332560000;0;400000000
1.06 . 1.06.01 . 15 . 03;Pemberdayaan Fakir Miskin;64440000;255560000;0;320000000
1.06 . 1.06.01 . 15 . 04;Pembinaan Organisasi Kesejahteraan Sosial;0;160000000;0;160000000
1.06 . 1.06.01 . 15 . 05;Pemberdayaan melalui Kemitraan Sosial;0;221990000;0;221990000
1.06 . 1.06.01 . 15 . 06;Pemberdayaan Tenaga Kesejahteraan Sosial Masyarakat (TKSM);0;287710000;0;287710000
1.06 . 1.06.01 . 15 . 07;Kegiatan Pengelolaan Sumber Dana Bantuan Sosial (PSDBS);27720000;72280000;0;100000000
1.06 . 1.06.01 . 15 . 08;Pemberdayaan Sosial Komunitas Adat Terpencil;27720000;327049000;0;354769000
1.06 . 1.06.01 . 16;Rehabilitasi Sosial;233640000;1017960000;0;1251600000
1.06 . 1.06.01 . 16 . 01;Pelayanan Kesejahteraan Sosial bagi PMKS Anak;120240000;431360000;0;551600000
1.06 . 1.06.01 . 16 . 02;Pelayanan Sosial Lanjut Usia;0;125000000;0;125000000
1.06 . 1.06.01 . 16 . 04;Sosialisasi Bahaya Penyalahgunaan Napza;27720000;72280000;0;100000000
1.06 . 1.06.01 . 16 . 05;Rehabilitasi Sosial Penyandang Disabilitas;30240000;269760000;0;300000000
1.06 . 1.06.01 . 16 . 06;Rehabilitasi Sosial Tuna Sosial dan KPO;55440000;119560000;0;175000000
1.06 . 1.06.01 . 20;Perlindungan dan Jaminan Kesejahteraan Sosial;828880000;1074920000;0;1903800000
1.06 . 1.06.01 . 20 . 03;Perlindungan Jaminan Sosial Keluarga dan Pendataan PMKS;828880000;414920000;0;1243800000
1.06 . 1.06.01 . 20 . 05;Perlindungan Sosial Korban Bencana Sosial;0;350000000;0;350000000
1.06 . 1.06.01 . 20 . 06;Perlindungan Sosial Korban Bencana Alam;0;310000000;0;310000000
1.06 . 1.06.01 . 26;Program Penanganan Fakir Miskin;83160000;266840000;0;350000000
1.06 . 1.06.01 . 26 . 01;Penanganan Fakir Miskin Perdesaan;83160000;266840000;0;350000000
1.06 . 1.06.02;BADAN PENANGGULANGAN BENCANA DAERAH;462425000;3723965200;795609800;4982000000
1.06 . 1.06.02 . 01;Pelayanan Administrasi, Sarana Prasarana dan SDM Aparatur;30360000;1170273200;795609800;1996243000
1.06 . 1.06.02 . 01 . 01;Pelayanan Jasa Administrasi Perkantoran;30360000;476640000;0;507000000
1.06 . 1.06.02 . 01 . 02;Peningkatan Sarana dan Prasarana Perkantoran;0;584233200;795609800;1379843000
1.06 . 1.06.02 . 01 . 03;Peningkatan Kapasitas SDM Aparatur;0;109400000;0;109400000
1.06 . 1.06.02 . 02;Peningkatan Perencanaan, Evaluasi dan Pelaporan;141240000;387662000;0;528902000
1.06 . 1.06.02 . 02 . 01;Penyusunan Anggaran dan Laporan Keuangan SKPD;55440000;28360000;0;83800000
1.06 . 1.06.02 . 02 . 02;Perencanaan, Koordinasi, Monitoring Evaluasi dan Pelaporan;85800000;359302000;0;445102000
1.06 . 1.06.02 . 23;Pencegahan dan Kesiapsiagaan;91080000;1089615000;0;1180695000
1.06 . 1.06.02 . 23 . 01;Sosialisasi Pengurangan Resiko Bencana;30360000;250460000;0;280820000
1.06 . 1.06.02 . 23 . 05;Apel Hari Kesiapsiagaan Bencana Nasional (HKBN);0;166150000;0;166150000
1.06 . 1.06.02 . 23 . 06;Penyusunan Dokumen Rencana Aksi Daerah (RAD) Penaggulangan Bencana Provinsi Gorontalo;30360000;415565000;0;445925000
1.06 . 1.06.02 . 23 . 09;Fasilitasi Desa/Kelurahan Tangguh Bencana (Destana);30360000;257440000;0;287800000
1.06 . 1.06.02 . 24;Kedaruratan dan Logistik;171600000;627060000;0;798660000
1.06 . 1.06.02 . 24 . 02;PUSDALOPS (Pusat Pengendalian Operasi Sistem Penanggulangan Bencana);116160000;61500000;0;177660000
1.06 . 1.06.02 . 24 . 03;Mobilsasi Sumber daya Peralatan dan logistik;55440000;244560000;0;300000000
1.06 . 1.06.02 . 24 . 05;Pemenuhan Kebutuhan dasar Korban Bencana;0;200000000;0;200000000
1.06 . 1.06.02 . 24 . 06;Optimalisasi Tim Reaksi Cepat BPBD;0;121000000;0;121000000
1.06 . 1.06.02 . 25;Rehabilitasi dan Rekonstruksi;28145000;449355000;0;477500000
1.06 . 1.06.02 . 25 . 01;Inventarisasi Kerusakan Infrastruktur;0;141750000;0;141750000
1.06 . 1.06.02 . 25 . 02;Peningkatan Peran dan Partisipasi Lembaga/Organisasi Kemasyarakatan, Dunia Usaha Dan Masyarakat;28145000;122705000;0;150850000
1.06 . 1.06.02 . 25 . 06;Sosialisasi Pemulihan Psikology Pasca Bencana;0;91530000;0;91530000
1.06 . 1.06.02 . 25 . 07;Pengkajian Kebutuhan Pasca Bencana (JITUPASNA);0;93370000;0;93370000
2;Urusan Wajib Bukan Pelayanan Dasar;6881290000;46724445197;13897176600;67502911797
02.01;Tenaga Kerja;252060000;2633357850;0;2885417850
2.01 . 2.12.01;DINAS PENANAMAN MODAL, ESDM DAN TRANSMIGRASI;252060000;2633357850;0;2885417850
2.01 . 2.12.01 . 15;Peningkatan Kualitas dan Produktivitas Tenaga Kerja;158400000;1367718000;0;1526118000
2.01 . 2.12.01 . 15 . 01;Pemagangan Berbasis Pengguna;79200000;1053295000;0;1132495000
2.01 . 2.12.01 . 15 . 07;Pemagangan Luar Negeri;79200000;314423000;0;393623000
2.01 . 2.12.01 . 17;Program Perlindungan Tenaga Kerja dan Sistem Pengawasan Ketenagakerjaan;27720000;208530000;0;236250000
2.01 . 2.12.01 . 17 . 02;Peningkatan pengawasan, perlindungan dan penegakkan hukum terhadap keselamatan dan kesehatan kerja;27720000;208530000;0;236250000
2.01 . 2.12.01 . 18;Program Pelatihan Berbasis Kompetensi Tenaga Kerja, Latihan Transmigrasi dan Pengembangan Produktifitas Daerah (UPTD BLK);10500000;415492600;0;425992600
2.01 . 2.12.01 . 18 . 01;Pelatihan dan Pengembangan Produktivitas;0;70996300;0;70996300
2.01 . 2.12.01 . 18 . 02;Pendidikan dan Pelatihan Kompetensi bagi Tenaga Kerja dan Pencari Kerja;10500000;344496300;0;354996300
2.01 . 2.12.01 . 19;Penempatan dan Perluasan  Kesempatan kerja;0;228175000;0;228175000
2.01 . 2.12.01 . 19 . 04;Pendayagunaan Tenaga Kerja Perempuan;0;228175000;0;228175000
2.01 . 2.12.01 . 20;Pengembangan Hubungan Industrial dan Peningkatan Jaminan Sosial Tenaga kerja;55440000;413442250;0;468882250
2.01 . 2.12.01 . 20 . 01;Penyusunan dan Penetapan Upah Minimum Provinsi;55440000;325072250;0;380512250
2.01 . 2.12.01 . 20 . 02;Pembinaan dan Penyelesaian Sengketa/Perselisihan Hubungan Industrial;0;88370000;0;88370000
02.02;Pemberdayaan Perempuan dan Perlindungan Anak;102120000;1437390000;0;1539510000
2.02 . 1.06.01;DINAS SOSIAL, PEMBERDAYAAN PEREMPUAN DAN PERLINDUNGAN ANAK;102120000;1437390000;0;1539510000
2.02 . 1.06.01 . 23;Peningkatan Kualitas Hidup Perempuan dan Penguatan Kelembagaan Pengarutamaan Gender;54120000;860390000;0;914510000
2.02 . 1.06.01 . 23 . 11;Pemberian Bantuan Usaha untuk Perempuan kepala keluarga (PEKKA) melalui usaha industri rumah tangga;26400000;318600000;0;345000000
2.02 . 1.06.01 . 23 . 12;Rembug DUDI (Dunia Usaha dan Dunia Industri) untuk Pemberdayaan Perempuan dan Perlindungan Anak;0;190410000;0;190410000
2.02 . 1.06.01 . 23 . 13;Penyediaan data SIGA Daerah (Sistem Informasi Gender dan Anak);0;179100000;0;179100000
2.02 . 1.06.01 . 23 . 14;Pelatihan PPRG bagi Aparatur Perangkat Daerah;27720000;172280000;0;200000000
2.02 . 1.06.01 . 24;Program Pemenuhan hak Perempuan dan Anak serta peningkatan perlindungan Perempuan dan Anak;48000000;577000000;0;625000000
2.02 . 1.06.01 . 24 . 01;Advokasi Implementasi Pencapaian Kabupaten/Kota Layak Anak;0;200000000;0;200000000
2.02 . 1.06.01 . 24 . 02;Kegiatan Pemberian Layanan Perlindungan Khusus Anak;24000000;101000000;0;125000000
2.02 . 1.06.01 . 24 . 03;Penguatan Kapasitas Lembaga Layanan Perlindungan Perempuan dan Anak;24000000;176000000;0;200000000
2.02 . 1.06.01 . 24 . 04;Pemberian Edukasi Kepada Para Pihak sebagai Upaya dan strategi Pencegahan Kekerasan terhadap Perempuan;0;100000000;0;100000000
02.03;Pangan;839760000;3120317000;114400000;4074477000
2.03 . 2.03.01;DINAS PANGAN;839760000;3120317000;114400000;4074477000
2.03 . 2.03.01 . 01;Progam Pelayanan Administrasi, Sarana dan Prasarana dan SDM Aparatur;128040000;587490000;78400000;793930000
2.03 . 2.03.01 . 01 . 01;Pelayanan Jasa Administrasi Perkantoran;128040000;248180000;0;376220000
2.03 . 2.03.01 . 01 . 02;Peningkatan Sarana dan Prasarana Perkantoran;0;227510000;78400000;305910000
2.03 . 2.03.01 . 01 . 03;Peningkatan Kapasitas Sumber Daya Aparatur;0;111800000;0;111800000
2.03 . 2.03.01 . 02;Program Perencanaan, Evaluasi, Monitoring dan Pelaporan;162360000;361810000;0;524170000
2.03 . 2.03.01 . 02 . 01;Perencanaan, Koordinasi, Evaluasi dan Pelaporan;81840000;342330000;0;424170000
2.03 . 2.03.01 . 02 . 02;Penatausahaan dan Penyusunan Laporan Keuangan;80520000;19480000;0;100000000
2.03 . 2.03.01 . 15;Program Ketersediaan dan Kerawanan Pangan;158400000;952383000;0;1110783000
2.03 . 2.03.01 . 15 . 01;Analisis Data Ketersediaan dan Kerawanan Pangan (Prognosa HBKN, NBM, PPH & AKG, Pola Panen Bulanan, SKPG, FSVA dan Akses Pangan);27720000;78623000;0;106343000
2.03 . 2.03.01 . 15 . 02;Kios Akses Pangan Masyarakat;77880000;509140000;0;587020000
2.03 . 2.03.01 . 15 . 03;Penanganan Daerah Rawan Pangan;52800000;364620000;0;417420000
2.03 . 2.03.01 . 16;Program Pengembangan Distribusi, Pemantauan, dan Stabilisasi Harga serta Penguatan Cadangan Pangan;158400000;490217000;0;648617000
2.03 . 2.03.01 . 16 . 01;Penguatan Kelembagaan Pangan Lokal (Gapoktan/Kelompok) Dalam Upaya Stabilisasi Harga Tingkat Produsen;50160000;170200000;0;220360000
2.03 . 2.03.01 . 16 . 02;Stabilisasi Harga Pangan di tingkat Konsumen;54120000;42417000;0;96537000
2.03 . 2.03.01 . 16 . 03;Penguatan Cadangan Pangan Pemerintah dan Masyarakat;54120000;277600000;0;331720000
2.03 . 2.03.01 . 17;Program Pengembangan Diversifikasi Pangan dan Peningkatan Keamanan Pangan Segar;232560000;728417000;36000000;996977000
2.03 . 2.03.01 . 17 . 01;Penganekaragaman Konsumsi Pangan;108960000;282085000;36000000;427045000
2.03 . 2.03.01 . 17 . 02;Pengembangan Pangan Pokok Lokal dan Tradisional;43080000;157507000;0;200587000
2.03 . 2.03.01 . 17 . 03;Analisis Pola Konsumsi Pangan Masyarakat Berdasarkan PPH;27720000;56060000;0;83780000
2.03 . 2.03.01 . 17 . 04;Pengawasan Keamanan dan Mutu Pangan Segar Asal Tumbuhan;27720000;132845000;0;160565000
2.03 . 2.03.01 . 17 . 05;Pengujian dan Sertifikasi Jaminan Mutu dan Keamanan Pangan Segar;25080000;99920000;0;125000000
02.05;Lingkungan Hidup;1086750000;3513570000;2201182000;6801502000
2.05 . 2.05.01;DINAS LINGKUNGAN HIDUP DAN KEHUTANAN;1086750000;3513570000;2201182000;6801502000
2.05 . 2.05.01 . 01;Peningkatan Pelayanan Administrasi, Sarana Prasarana dan SDM Aparatur;582500000;1403543000;301182000;2287225000
2.05 . 2.05.01 . 01 . 01;Pelayanan Administrasi Perkantoran;320400000;335435000;0;655835000
2.05 . 2.05.01 . 01 . 02;Peningkatan Sarana dan Prasarana Perkantoran;18000000;400360000;138740000;557100000
2.05 . 2.05.01 . 01 . 03;Peningkatan Kapasitas SDM Aparatur;0;52090000;0;52090000
2.05 . 2.05.01 . 01 . 04;Pelayanan Administrasi Perkantoran (UPTD KPH Unit I dan II Gorontalo Barat);50400000;84670000;0;135070000
2.05 . 2.05.01 . 01 . 05;Peningkatan Sarana dan Prasarana Perkantoran (UPTD KPH Unit I dan II Gorontalo Barat);3500000;10330000;12500000;26330000
2.05 . 2.05.01 . 01 . 06;Pelayanan Administrasi Perkantoran (UPTD KPH Unit III Pohuwato);38400000;96216000;0;134616000
2.05 . 2.05.01 . 01 . 07;Peningkatan Sarana dan Prasarana Perkantoran (UPTD KPH Unit III Pohuwato);16800000;85584000;34000000;136384000
2.05 . 2.05.01 . 01 . 08;Pelayanan Administrasi Perkantoran (UPTD KPH Unit IV Gorontalo Utara);43200000;47250000;0;90450000
2.05 . 2.05.01 . 01 . 09;Peningkatan Sarana dan Prasarana Perkantoran (UPTD KPH Unit IV Gorontalo Utara);0;35250000;25300000;60550000
2.05 . 2.05.01 . 01 . 10;Pelayanan Administrasi Perkantoran (UPTD KPH Unit V Boalemo);37200000;76900000;0;114100000
2.05 . 2.05.01 . 01 . 11;Peningkatan Sarana dan Prasarana Perkantoran (UPTD KPH Unit V Boalemo);4200000;10490000;19410000;34100000
2.05 . 2.05.01 . 01 . 12;Pelayanan Administrasi Perkantoran (UPTD KPH Unit VI Gorontalo);16800000;30200000;0;47000000
2.05 . 2.05.01 . 01 . 13;Peningkatan Sarana dan Prasarana Perkantoran (UPTD KPH Unit VI Gorontalo);0;48768000;34232000;83000000
2.05 . 2.05.01 . 01 . 14;Pelayanan Administrasi Perkantoran (UPTD KPH Unit VII Bone Bolango dan Kota Gorontalo);33600000;44000000;0;77600000
2.05 . 2.05.01 . 01 . 15;Peningkatan Sarana dan Prasarana Perkantoran  (UPTD KPH Unit VII Bone Bolango dan Kota Gorontalo);0;46000000;37000000;83000000
2.05 . 2.05.01 . 02;Perencanaan, Koordinasi, Monitoring dan Evaluasi;290400000;733877000;0;1024277000
2.05 . 2.05.01 . 02 . 01;Perencanaan, Koordinasi, Monitoring dan Evaluasi;234960000;639317000;0;874277000
2.05 . 2.05.01 . 02 . 02;Penatausahaan dan Penyusunan Laporan Keuangan;55440000;94560000;0;150000000
2.05 . 2.05.01 . 04;Pengendalian Pencemaran dan Kerusakan Lingkungan;174240000;1002760000;0;1177000000
2.05 . 2.05.01 . 04 . 01;Pemantauan Kualitas Lingkungan (Air dan Udara);27720000;218670000;0;246390000
2.05 . 2.05.01 . 04 . 02;Pembinaan dan Pengawasan Terhadap Pelaksanaan Ketentuan Izin Lingkungan, PPA, PPU;58080000;105610000;0;163690000
2.05 . 2.05.01 . 04 . 03;Pembinaan Teknis Pelaksanaan Administrasi Proses Amdal, UKL-UPL & SPPL;30360000;91250000;0;121610000
2.05 . 2.05.01 . 04 . 04;Pembinaan dan Pengawasan Pengelolaan Limbah B3 Fasilitas Pelayanan Kesehatan;0;96010000;0;96010000
2.05 . 2.05.01 . 04 . 05;Pembinaan dan Peningkatan Kapasitas Masyarakat Dalam Pengelolaan Sampah Melalui Program 3R;0;264300000;0;264300000
2.05 . 2.05.01 . 04 . 06;Penyusunan Dokumen Informasi Kinerja Pengelolaan Lingkungan Hidup Daaerah (DIKPLHD) dan Indeks Kualitas Lingkungan Hidup (IKLH);30360000;119640000;0;150000000
2.05 . 2.05.01 . 04 . 07;Penyusunan Valuasi Ekonomi Pencemaran LH dan Kerusakan SDA Provinsi Gorontalo;27720000;107280000;0;135000000
2.05 . 2.05.01 . 06;Peningkatan Kapasitas SDM Dalam Pengelolaan Lingkungan Hidup dan Kehutanan;39610000;273390000;0;313000000
2.05 . 2.05.01 . 06 . 01;Pemberdayaan dan Peningkatan Kapasitas Masyarakat Dalam Mendukung Provinsi Konservasi;39610000;110390000;0;150000000
2.05 . 2.05.01 . 06 . 02;Pembinaan / Penilaian Adipura & Sekolah Adiwiyata;0;163000000;0;163000000
2.05 . 2.05.01 . 16;Pengendalian Pencemaran dan Kerusakan Lingkungan (DAK FISIK);0;100000000;1900000000;2000000000
2.05 . 2.05.01 . 16 . 01;Pemantauan Kualitas Air secara Online (DAK Fisik);0;100000000;1900000000;2000000000
02.06;Administrasi Kependudukan dan Capil;0;292529000;0;292529000
2.06 . 2.07.01;DINAS PEMBERDAYAAN MASYARAKAT DAN DESA, ADMINISTRASI KEPENDUDUKAN PENCATATAN SIPIL;0;292529000;0;292529000
2.06 . 2.07.01 . 16;Program Penataan Administrasi Kependudukan dan Pencatatan Sipil (DAK);0;292529000;0;292529000
2.06 . 2.07.01 . 16 . 03;Pelaksanaan Penerbitan KTP-el di Kabupaten/Kota (DAK);0;67314000;0;67314000
2.06 . 2.07.01 . 16 . 04;Pengelolaan Sistem Informasi Administrasi Kependudukan (SIAK) (DAK);0;61365000;0;61365000
2.06 . 2.07.01 . 16 . 05;Koordinasi dan Konsultasi Penyelenggaraan Pelayanan Administrasi Kependudukan (DAK);0;163850000;0;163850000
02.07;Pemberdayaan Masyarakat Desa;1169730000;5363240000;187010000;6719980000
2.07 . 2.07.01;DINAS PEMBERDAYAAN MASYARAKAT DAN DESA, ADMINISTRASI KEPENDUDUKAN PENCATATAN SIPIL;1169730000;5363240000;187010000;6719980000
2.07 . 2.07.01 . 01;Program Pelayanan Administrasi, Sarana Prasarana dan SDM Aparatur;406560000;861580000;187010000;1455150000
2.07 . 2.07.01 . 01 . 01;Pelayanan Jasa Administrasi Perkantoran;406560000;403880000;0;810440000
2.07 . 2.07.01 . 01 . 02;Peningkatan Sarana dan Prasarana Perkantoran;0;357700000;187010000;544710000
2.07 . 2.07.01 . 01 . 03;Peningkatan Kapasitas Sumber Daya Aparatur;0;100000000;0;100000000
2.07 . 2.07.01 . 02;Perencanaan, Evaluasi, Monitoring dan Pelaporan;60720000;689330000;0;750050000
2.07 . 2.07.01 . 02 . 01;Sistem Pengendalian, Koordinasi, Evaluasi dan Pelaporan Program Kegiatan;60720000;621330000;0;682050000
2.07 . 2.07.01 . 02 . 02;Penyusunan Anggaran, Penatausahaan  dan Penyusunan  Laporan Keuangan SKPD;0;68000000;0;68000000
2.07 . 2.07.01 . 16;Program Pengembangan Perdesaan;30360000;323680000;0;354040000
2.07 . 2.07.01 . 16 . 02;Evaluasi Perkembangan Desa dan Kelurahan;30360000;323680000;0;354040000
2.07 . 2.07.01 . 19;Program Tim Penggerak Pembinaan Kesejahteraan Keluarga;229680000;1037474000;0;1267154000
2.07 . 2.07.01 . 19 . 02;Peningkatan Program Tertib Administrasi;229680000;795324000;0;1025004000
2.07 . 2.07.01 . 19 . 03;Penghayatan, Pengamalan, Pancasila dan Gotong Royong;0;72800000;0;72800000
2.07 . 2.07.01 . 19 . 04;Pengembangan Kehidupan Berkoperasi Serta Pendidikan dan Keterampilan;0;55800000;0;55800000
2.07 . 2.07.01 . 19 . 05;Pangan, Sandang , Perumahan dan Tata Laksana Rumah Tangga;0;62800000;0;62800000
2.07 . 2.07.01 . 19 . 06;Kesehatan, Kelestarian, Lingkungan Hidup, dan Perencanaan Sehat;0;50750000;0;50750000
2.07 . 2.07.01 . 21;Pembangunan  dan pemberdayaan Masyarakat Desa/kelurahan Serta Kawasan Perdesaan;172920000;1131411000;0;1304331000
2.07 . 2.07.01 . 21 . 04;Peningkatan Kapasitas BP-SPAMS;30360000;119640000;0;150000000
2.07 . 2.07.01 . 21 . 06;Rapat Koordinasi Pembangunan Kawasan Perdesaan Tingkat Provinsi Gorontalo;0;100000000;0;100000000
2.07 . 2.07.01 . 21 . 10;Pelatihan dan Bimbingan Teknis/ Sosialisasi Pendayagunaan TTG;29040000;340960000;0;370000000
2.07 . 2.07.01 . 21 . 13;Peningkatan Pelayanan Sosial Dasar Masyarakat Desa;85800000;214200000;0;300000000
2.07 . 2.07.01 . 21 . 14;Monitoring dan Evaluasi Penyediaan Sarana dan Prasarana Kawasan Perdesaan;0;113000000;0;113000000
2.07 . 2.07.01 . 21 . 16;Pemberdayaan Lembaga Kemasyarakatan Pedesaan Lintas Kabupaten/Kota;27720000;243611000;0;271331000
2.07 . 2.07.01 . 22;Program Peningkatan Kualitas Penyelenggaraan Pemerintahan Desa/Kelurahan;120330000;1003680000;0;1124010000
2.07 . 2.07.01 . 22 . 02;Pembinaan dan pengendalian pendamping dana desa;60720000;609280000;0;670000000
2.07 . 2.07.01 . 22 . 07;Pengembangan Kapasitas Kerjasama Lembaga Desa/Kelurahan;29040000;70960000;0;100000000
2.07 . 2.07.01 . 22 . 08;Pembinaan dan Pembangunan Desa Tata Kelola Pemerintahan;30570000;323440000;0;354010000
2.07 . 2.07.01 . 23;Program Pengembangan Ekonomi Produktif Masyarakat Miskin;149160000;316085000;0;465245000
2.07 . 2.07.01 . 23 . 02;Pengembangan Ekonomi Inklusif Berbasis Teknologi bagi Masyarakat Miskin di Pedesaan (Smart Farming);149160000;316085000;0;465245000
02.09;Perhubungan;708540000;4194008000;1056750000;5959298000
2.09 . 2.09.01;DINAS PERHUBUNGAN;708540000;4194008000;1056750000;5959298000
2.09 . 2.09.01 . 01;Pelayanan Administrasi, Sarana Prasarana dan SDM Aparatur;91080000;1019998000;148500000;1259578000
2.09 . 2.09.01 . 01 . 01;Pelayanan Jasa Administrasi Perkantoran;91080000;410276000;0;501356000
2.09 . 2.09.01 . 01 . 02;Peningkatan Sarana dan Prasarana Perkantoran;0;494722000;148500000;643222000
2.09 . 2.09.01 . 01 . 03;Peningkatan Kapasitas SDM Aparatur;0;115000000;0;115000000
2.09 . 2.09.01 . 02;Peningkatan Perencanaan, Monitoring, Evaluasi dan Pelaporan;139920000;527080000;0;667000000
2.09 . 2.09.01 . 02 . 01;Perencanaan Koordinasi Monitoring dan Evaluasi;84480000;515520000;0;600000000
2.09 . 2.09.01 . 02 . 02;Penatausahaan dan Penyusunan Laporan Keuangan;55440000;11560000;0;67000000
2.09 . 2.09.01 . 17;Program Peningkatan Layanan Transportasi;249180000;1988540000;0;2237720000
2.09 . 2.09.01 . 17 . 21;Pelayanan Angkutan Perintis;191100000;1458900000;0;1650000000
2.09 . 2.09.01 . 17 . 22;Pembinaan dan Penertiban;27720000;252280000;0;280000000
2.09 . 2.09.01 . 17 . 23;Pengadaan Aplikasi Layanan Publik;30360000;27360000;0;57720000
2.09 . 2.09.01 . 17 . 25;Penyusunan Dokumen Perencanaan Studi Pelayanan BRT;0;250000000;0;250000000
2.09 . 2.09.01 . 20;Program Peningkatan Kinerja Pelayanan Transportasi;168960000;476040000;0;645000000
2.09 . 2.09.01 . 20 . 01;Dukungan Kelancaran Transportasi;138600000;321400000;0;460000000
2.09 . 2.09.01 . 20 . 02;Koordinasi dan Kerjasama Pengembangan Sapras Perhubungan;30360000;154640000;0;185000000
2.09 . 2.09.01 . 21;Program Peningkatan Kapasitas Keselamatan Transportasi;59400000;182350000;908250000;1150000000
2.09 . 2.09.01 . 21 . 01;Pengadaan dan Pemasangan Fasilitas Keselamatan LLAJ;59400000;82350000;908250000;1050000000
2.09 . 2.09.01 . 21 . 02;Pemeliharaan Faskes LLAJ;0;100000000;0;100000000
02.10;Komunikasi dan Informatika;603330000;5522634000;3035334600;9161298600
2.10 . 2.10.01;DINAS KOMUNIKASI, INFORMATIKA DAN STATISTIK;603330000;5522634000;3035334600;9161298600
2.10 . 2.10.01 . 01;Peningkatan Pelayanan Administrasi, Sarana dan Prasarana serta Sumber Daya Aparatur;203280000;1227810000;1448760000;2879850000
2.10 . 2.10.01 . 01 . 01;Pelayanan Jasa Administrasi Perkantoran;203280000;453715000;0;656995000
2.10 . 2.10.01 . 01 . 02;Peningkatan Sarana dan Prasarana Perkantoran;0;444985000;1448760000;1893745000
2.10 . 2.10.01 . 01 . 03;Peningkatan Kapasitas SDM Aparatur;0;329110000;0;329110000
2.10 . 2.10.01 . 02;Program Peningkatan Perencanaan, Monitoring dan Evaluasi;88440000;255980000;0;344420000
2.10 . 2.10.01 . 02 . 01;Penatausahaan dan Laporan Keuangan SKPD;88440000;255980000;0;344420000
2.10 . 2.10.01 . 15;Program Pengembangan Komunikasi, Informasi Dan Media Massa;311610000;4038844000;1586574600;5937028600
2.10 . 2.10.01 . 15 . 07;Peningkatan Layanan Infrastruktur TIK Provinsi;248250000;3410254000;1586574600;5245078600
2.10 . 2.10.01 . 15 . 09;Pengelolaan dan Layanan Data Informasi Sistem E-Government;0;112350000;0;112350000
2.10 . 2.10.01 . 15 . 10;Aplikasi Sistem Informasi Manajemen dan Website Seluruh OPD;33000000;121600000;0;154600000
2.10 . 2.10.01 . 15 . 11;Layanan Informasi;0;75000000;0;75000000
2.10 . 2.10.01 . 15 . 13;Layanan Komunikasi Publik;30360000;119640000;0;150000000
2.10 . 2.10.01 . 15 . 14;Pengembangan Kelompok Informasi Masyarakat (KIM) dan Media Tradisional;0;200000000;0;200000000
02.11;Koperasi, Usaha Kecil dan Menengah;820720000;5461173000;1036800000;7318693000
2.11 . 2.11.01;DINAS KOPERASI, UKM, PERINDUSTRIAN DAN PERDAGANGAN;820720000;5461173000;1036800000;7318693000
2.11 . 2.11.01 . 01;Program Pelayanan Administrasi, Sarana Prasarana dan SDM Aparatur;234960000;1442840000;1036800000;2714600000
2.11 . 2.11.01 . 01 . 01;Pelayanan Jasa Administrasi Perkantoran;176880000;525120000;0;702000000
2.11 . 2.11.01 . 01 . 02;Peningkatan Sarana dan Prasarana Perkantoran;0;639000000;1036800000;1675800000
2.11 . 2.11.01 . 01 . 03;Peningkatan Kapasitas SDM Aparatur;0;178800000;0;178800000
2.11 . 2.11.01 . 01 . 04;Pelayanan Jasa Administrasi UPTD BPSMB;58080000;99920000;0;158000000
2.11 . 2.11.01 . 02;Program Peningkatan Perencanaan, Evaluasi dan Pelaporan;30360000;1019640000;0;1050000000
2.11 . 2.11.01 . 02 . 01;Perencanaan, Koordinasi, Monitoring dan Evaluasi;30360000;869640000;0;900000000
2.11 . 2.11.01 . 02 . 02;Penatausahaan dan Penyusunan Laporan Keuangan;0;150000000;0;150000000
2.11 . 2.11.01 . 13;Peningkatan Kapasitas Koperasi UKM dan Ketenagakerjaan (DAK);497050000;2052950000;0;2550000000
2.11 . 2.11.01 . 13 . 01;Peningkatan Kapasitas SDM UMKM (DAK);216150000;881200000;0;1097350000
2.11 . 2.11.01 . 13 . 02;Peningkatan Kapasitas SDM Koperasi (DAK);280900000;1171750000;0;1452650000
2.11 . 2.11.01 . 15;Program Pengembangan KUKM;30630000;493363000;0;523993000
2.11 . 2.11.01 . 15 . 01;Penguatan SDM dan Kelembagaan Koperasi;0;101090000;0;101090000
2.11 . 2.11.01 . 15 . 02;Pembinaan, Pengawasan dan Penghargaan Koperasi Berprestasi;270000;138683000;0;138953000
2.11 . 2.11.01 . 15 . 03;Peningkatan Akses Permodalan dan Efektifitas Pembiayaan Bagi KUKM;30360000;253590000;0;283950000
2.11 . 2.11.01 . 16;Program Pengembangan UMKM;27720000;452380000;0;480100000
2.11 . 2.11.01 . 16 . 01;Peningkatan SDM dan Penguatan Kelembagaan UMKM;27720000;172280000;0;200000000
2.11 . 2.11.01 . 16 . 02;Pembinaan UMKM Naik Kelas;0;180100000;0;180100000
2.11 . 2.11.01 . 16 . 04;Promosi dan Pemasaran Produk UMKM;0;100000000;0;100000000
02.12;Penanaman Modal;534900000;3934562150;1834500000;6303962150
2.12 . 2.12.01;DINAS PENANAMAN MODAL, ESDM DAN TRANSMIGRASI;534900000;3934562150;1834500000;6303962150
2.12 . 2.12.01 . 01;Pelayanan Administrasi Sarana Prasarana dan SDM Aparatur;413520000;2004528500;1834500000;4252548500
2.12 . 2.12.01 . 01 . 01;Pelayanan Jasa Administrasi Perkantoran;319440000;950610000;0;1270050000
2.12 . 2.12.01 . 01 . 02;Peningkatan Kualitas SDM;0;165700000;0;165700000
2.12 . 2.12.01 . 01 . 03;Peningkatan Sarana dan Prasarana Perkantoran;0;721690000;1834500000;2556190000
2.12 . 2.12.01 . 01 . 04;Pelayanan Jasa Administrasi BLK Perkantoran BLK;94080000;166528500;0;260608500
2.12 . 2.12.01 . 02;Program Perencanaan, Evaluasi, Monitoring dan Pelaporan;31740000;672340000;0;704080000
2.12 . 2.12.01 . 02 . 01;Perencanaan, Koordinasi, Monitoring dan Evaluasi;0;554080000;0;554080000
2.12 . 2.12.01 . 02 . 02;Penatausahaan dan Pelaporan Keuangan;31740000;118260000;0;150000000
2.12 . 2.12.01 . 15;Program Peningkatan Promosi dan Kerjasama Investasi;27720000;521216150;0;548936150
2.12 . 2.12.01 . 15 . 05;Promosi Investasi;27720000;271771150;0;299491150
2.12 . 2.12.01 . 15 . 06;Pengembangan Usaha;0;104445000;0;104445000
2.12 . 2.12.01 . 15 . 07;Identifikasi Potensi Investasi;0;145000000;0;145000000
2.12 . 2.12.01 . 16;Program Peningkatan Iklim Investasi dan Realisasi Investasi;61920000;736477500;0;798397500
2.12 . 2.12.01 . 16 . 01;Penyelenggaraan PTSP;61920000;441477500;0;503397500
2.12 . 2.12.01 . 16 . 02;Pengendalian Pelaksanaan Penanaman Modal;0;295000000;0;295000000
02.13;Kepemudaan dan Olah Raga;46780000;5139655900;0;5186435900
2.13 . 1.01.01;DINAS PENDIDIKAN, KEBUDAYAAN, PEMUDA DAN OLAHRAGA;46780000;5139655900;0;5186435900
2.13 . 1.01.01 . 19;Program Pembinaan Pemuda dan Olahraga;46780000;5139655900;0;5186435900
2.13 . 1.01.01 . 19 . 02;Kegiatan Penyiapan dan Pelatihan paskibraka;45880000;948996000;0;994876000
2.13 . 1.01.01 . 19 . 03;Kegiatan seleksi PPAN,PPAP, Kirab Pemuda, Pemuda kreatif dan KPN Nasional dan Internasional;900000;48725000;0;49625000
2.13 . 1.01.01 . 19 . 06;Kegiatan Prestasi Olahraga di Tingkat Regional/Nasional/Internasional;0;2235099800;0;2235099800
2.13 . 1.01.01 . 19 . 07;Kegiatan Pembinaan dan Pemasyarakatan Olahraga;0;1769800100;0;1769800100
2.13 . 1.01.01 . 19 . 09;Kegiatan Pembinaan Olahraga Tradisional;0;137035000;0;137035000
02.14;Statistik;161600000;438400000;0;600000000
2.14 . 2.10.01;DINAS KOMUNIKASI, INFORMATIKA DAN STATISTIK;161600000;438400000;0;600000000
2.14 . 2.10.01 . 16;Program Pengembangan Data / Informasi;161600000;438400000;0;600000000
2.14 . 2.10.01 . 16 . 01;Pengumpulan dan Pengelolaan Data Pembangunan Provinsi Gorontalo;30360000;169640000;0;200000000
2.14 . 2.10.01 . 16 . 02;Peningkatan Monev dan Pengawasan Data Sektor di SKPD;58080000;141920000;0;200000000
2.14 . 2.10.01 . 16 . 03;Penyusunan Dan Pemutakhiran Data Pembangunan;73160000;126840000;0;200000000
02.15;Persandian;27720000;62880000;100000000;190600000
2.15 . 2.10.01;DINAS KOMUNIKASI, INFORMATIKA DAN STATISTIK;27720000;62880000;100000000;190600000
2.15 . 2.10.01 . 15;Program Pengembangan Komunikasi Informasi dan Media Massa;27720000;62880000;100000000;190600000
2.15 . 2.10.01 . 15 . 01;Infrastruktur Persandian Daerah;0;0;100000000;100000000
2.15 . 2.10.01 . 15 . 02;Penyelenggaraan Persandian untuk Pengamanan Informasi Daerah;27720000;62880000;0;90600000
02.16;Kebudayaan;0;3614510081;0;3614510081
2.16 . 1.01.01;DINAS PENDIDIKAN, KEBUDAYAAN, PEMUDA DAN OLAHRAGA;0;3614510081;0;3614510081
2.16 . 1.01.01 . 18;Program Pembinaan Kebudayaan;0;2164510081;0;2164510081
2.16 . 1.01.01 . 18 . 01;Kegiatan Penyusunan Dokumen Karya Seni Budaya;0;127092000;0;127092000
2.16 . 1.01.01 . 18 . 02;Kegiatan sertifikasi Ahli Cagar Budaya;0;320695000;0;320695000
2.16 . 1.01.01 . 18 . 03;Kegiatan Pelestarian Peninggalan Sejarah Purbakala, Museum dan Peninggalan Bawah Air;0;356945000;0;356945000
2.16 . 1.01.01 . 18 . 05;Kegiatan Pendokumentasian adat/tradisi dan nilai budaya Gorontalo;0;184750000;0;184750000
2.16 . 1.01.01 . 18 . 06;Kegiatan  Apresiasi Seni dan Budaya;0;979378081;0;979378081
2.16 . 1.01.01 . 18 . 08;Kegiatan Pelatihan/Bimtek Pelestarian dan Aktualisasi Adat Budaya Gorontalo;0;195650000;0;195650000
2.16 . 1.01.01 . 20;Program Penyelenggaraan Museum (DAK Non Fisik);0;1450000000;0;1450000000
2.16 . 1.01.01 . 20 . 01;Penyelenggaraan Museum (DAK Non Fisik);0;1450000000;0;1450000000
02.17;Perpustakaan;527280000;1406168216;4331200000;6264648216
2.17 . 2.17.01;DINAS KEARSIPAN DAN PERPUSTAKAAN;527280000;1406168216;4331200000;6264648216
2.17 . 2.17.01 . 01;Peningkatan Pelayanan Administrasi, Sarana Prasarana dan SDM Aparatur;527280000;501508216;40000000;1068788216
2.17 . 2.17.01 . 01 . 01;Pelayanan Jasa Administrasi Perkantoran;527280000;396477216;0;923757216
2.17 . 2.17.01 . 01 . 02;Peningkatan Sarana dan Prasarana Perkantoran;0;16800000;40000000;56800000
2.17 . 2.17.01 . 01 . 03;Peningkatan Kapasitas SDM;0;88231000;0;88231000
2.17 . 2.17.01 . 02;Peningkatan Perencanaan, Monitoring, Evaluasi dan Pelaporan;0;141176000;0;141176000
2.17 . 2.17.01 . 02 . 01;Monitoring dan Evaluasi Bidang Perpustakaan dan Kearsipan;0;50176000;0;50176000
2.17 . 2.17.01 . 02 . 02;Penatausahaan dan Penyusunan Laporan Keuangan;0;21000000;0;21000000
2.17 . 2.17.01 . 02 . 03;Pelaksanaan Koordinasi dan Konsultasi Bidang Kearsipan dan Perpsutakaan;0;70000000;0;70000000
2.17 . 2.17.01 . 11;Pengembangan Perpustakaan dan Minat Baca;0;763484000;0;763484000
2.17 . 2.17.01 . 11 . 01;Kemah Bakti Literasi;0;276975000;0;276975000
2.17 . 2.17.01 . 11 . 02;Bimbingan Teknis Pengelola Perpustakaan Sekolah dan Pustakawan;0;124000000;0;124000000
2.17 . 2.17.01 . 11 . 03;Pelestarian Karya Cetak dan Penelusuran Bibliografi/Katalog Induk Daerah (BID/KID);0;101200000;0;101200000
2.17 . 2.17.01 . 11 . 04;Pelayanan Perpustakaan Keliling;0;261309000;0;261309000
2.17 . 2.17.01 . 12;Peningkatan Pelayanan Administrasi, Sarana Prasarana dan SDM Aparatur (DAK Fisik Reguler);0;0;4291200000;4291200000
2.17 . 2.17.01 . 12 . 01;Rehabilitasi Gedung Fasilitas Layanan Perpustakaan Umum Provinsi (DAK Fisik Reguler);0;0;4291200000;4291200000
02.18;Kearsipan;0;590050000;0;590050000
2.18 . 2.17.01;DINAS KEARSIPAN DAN PERPUSTAKAAN;0;590050000;0;590050000
2.18 . 2.17.01 . 20;Penyelenggaraan Kearsipan;0;590050000;0;590050000
2.18 . 2.17.01 . 20 . 01;Bimtek Pengelolaan Kearsipan Daerah Berbasis Teknologi Informasi Komunikasi (TIK);0;80000000;0;80000000
2.18 . 2.17.01 . 20 . 02;Pameran Kearsipan dalam rangka HUT Provinsi dan Hari Arsip Nasional;0;100000000;0;100000000
2.18 . 2.17.01 . 20 . 03;Penelusuran, Penyelamatan dan Penduplikasian Dokumen Arsip di Provinsi Gorontalo;0;149300000;0;149300000
2.18 . 2.17.01 . 20 . 04;Jadwal Retensi Arsip dan Akuisisi Arsip;0;90000000;0;90000000
2.18 . 2.17.01 . 20 . 05;Lomba Pengelolaan Kearsipan Lembaga Kearsipan Daerah;0;75400000;0;75400000
2.18 . 2.17.01 . 20 . 06;Bimtek Pengelola Kearsipan;0;95350000;0;95350000
3;Urusan Pilihan;14695987000;76983783409;34834563470;126514333879
03.01;Kelautan dan Perikanan;2289270000;20913007180;10542909220;33745186400
3.01 . 3.01.01;DINAS KELAUTAN DAN PERIKANAN;2289270000;20913007180;10542909220;33745186400
3.01 . 3.01.01 . 01;Peningkatan Pelayanan Administrasi, Sarana Prasarana dan SDM Aparatur;2185440000;2560186400;1019200000;5764826400
3.01 . 3.01.01 . 01 . 01;Pelayanan Jasa Administrasi Perkantoran;665280000;463420000;0;1128700000
3.01 . 3.01.01 . 01 . 02;Peningkatan Sarana dan Prasarana Perkantoran;0;615600000;513200000;1128800000
3.01 . 3.01.01 . 01 . 03;Peningkatan SDM Aparatur;0;277776400;0;277776400
3.01 . 3.01.01 . 01 . 04;Pelayanan Jasa Administrasi Perkantoran (UPTD. Balai Perikanan Budidaya Laut dan Payau);926160000;271880000;0;1198040000
3.01 . 3.01.01 . 01 . 05;Pelayanan Jasa Administrasi Perkantoran (UPTD. BP2MDPP);113520000;81688000;0;195208000
3.01 . 3.01.01 . 01 . 06;Pelayanan Jasa Administrasi Perkantoran (UPTD PP Tenda);379080000;231185000;0;610265000
3.01 . 3.01.01 . 01 . 07;Pelayanan Jasa Administrasi Perkantoran (UPTD. PP Gentuma);101400000;61600000;0;163000000
3.01 . 3.01.01 . 01 . 08;Peningkatan Sarana dan Prasarana Perkantoran (UPTD. Balai Perikanan Budidaya Laut dan Payau);0;203710000;272000000;475710000
3.01 . 3.01.01 . 01 . 09;Peningkatan Sarana dan Prasarana Perkantoran (UPTD. BP2MDPP);0;119092000;180500000;299592000
3.01 . 3.01.01 . 01 . 10;Peningkatan Sarana dan Prasarana Perkantoran (UPTD PP. Tenda);0;193935000;16000000;209935000
3.01 . 3.01.01 . 01 . 11;Peningkatan Sarana dan Prasarana Perkantoran (UPTD. PP Gentuma);0;40300000;37500000;77800000
3.01 . 3.01.01 . 02;Peningkatan Perencanaan, Monitoring, Evaluasi dan Pelaporan;0;743550000;0;743550000
3.01 . 3.01.01 . 02 . 01;Perencanaan, Koordinasi, Monitoring dan Evaluasi;0;593550000;0;593550000
3.01 . 3.01.01 . 02 . 02;Penyelenggaraan Keuangan SKPD;0;150000000;0;150000000
3.01 . 3.01.01 . 07;Program Pemberdayaan Masyarakat dalam Pengawasan dan Pengendalian Sumberdaya Kelautan;103830000;690045000;0;793875000
3.01 . 3.01.01 . 07 . 01;Pelayanan Adminstrasi P2SDKP Kapal Pengawas Perikanan;0;268525000;0;268525000
3.01 . 3.01.01 . 07 . 02;Pembinaan, Pengendalian dan Pengawasan Sumberdaya Kelautan dan Perikanan;103830000;242520000;0;346350000
3.01 . 3.01.01 . 07 . 03;Operasional dan Pemeliharaan Kapal Pengawas/Speed Pengawas;0;179000000;0;179000000
3.01 . 3.01.01 . 08;Program Perlindungan dan Konservasi Sumber Daya Alam;0;613700000;0;613700000
3.01 . 3.01.01 . 08 . 01;Pengembangan Wilayah Pesisir dan Pulau Pulau Kecil;0;182000000;0;182000000
3.01 . 3.01.01 . 08 . 02;Pengembangan dan Pemantapan Kawasan Konservasi Laut, Suaka Perikanan, dan Keanekaragaman Hayati Laut;0;117900000;0;117900000
3.01 . 3.01.01 . 08 . 03;Pengendalian dan Pengawasan Pemanfaatan Sumber Daya Kelautan dan Perikanan;0;313800000;0;313800000
3.01 . 3.01.01 . 09;Program Pengelolaan Budidaya Laut, Payau dan Pemberdayaan Masyarakat Pesisir dan Pulau Pulau Kecil;0;779000000;0;779000000
3.01 . 3.01.01 . 09 . 01;Pengembangan Budidaya Air Payau;0;305000000;0;305000000
3.01 . 3.01.01 . 09 . 02;Pengembangan Budidaya Air Laut;0;175000000;0;175000000
3.01 . 3.01.01 . 09 . 03;Peningkatan Kemitraan Pelaku Usaha Perikanan;0;299000000;0;299000000
3.01 . 3.01.01 . 10;Program Pengembangan Perikanan Tangkap;0;7270000000;0;7270000000
3.01 . 3.01.01 . 10 . 01;Pengembangan Sarana dan Prasarana Perikanan Tangkap;0;7119210000;0;7119210000
3.01 . 3.01.01 . 10 . 02;Peningkatan Ketrampilan dan Pengetahuan Pelaku Usaha Perikanan Tangkap;0;150790000;0;150790000
3.01 . 3.01.01 . 11;Program Optimalisasi Pengelolaan dan pemasaran produksi perikanan;0;4657000000;0;4657000000
3.01 . 3.01.01 . 11 . 01;Peningkatan Jaminan Mutu dan Daya Saing Komoditi Perikanan;0;2871000000;0;2871000000
3.01 . 3.01.01 . 11 . 02;Penguatan Sistem Logistik Ikan Nasional;0;1615000000;0;1615000000
3.01 . 3.01.01 . 11 . 03;Peningkatan Kemitraan Pelaku Usaha dan Sistem Pemasaran Hasil Perikanan;0;171000000;0;171000000
3.01 . 3.01.01 . 12;Pembinaan dan Pengujian Mutu Hasil Perikanan  (UPTD Balai Pengujian, Penerapan Mutu, dan Diversifikasi Produk Perikanan);0;315033000;0;315033000
3.01 . 3.01.01 . 12 . 01;Penguatan Sistem Jaminan Mutu dan Keamanan Hasil Perikanan (UPTD BP2MDPP);0;315033000;0;315033000
3.01 . 3.01.01 . 13;Program Peningkatan Produksi dan Pelayanan Teknis (UPTD Balai Perikanan Budidaya Laut dan Payau);0;825000000;0;825000000
3.01 . 3.01.01 . 13 . 01;Peningkatan Produksi Benih Unggul (UPTD. Balai Perikanan Budidaya Laut dan Payau);0;825000000;0;825000000
3.01 . 3.01.01 . 14;Program Pelayanan Sarana Produksi Perikanan (UPTD Pelabuhan Perikanan Tenda);0;369000000;370000000;739000000
3.01 . 3.01.01 . 14 . 01;Peningkatan Mutu Pelayanan Kepelabuhanan (UPTD PP. Tenda);0;275100000;0;275100000
3.01 . 3.01.01 . 14 . 02;Penyediaan Sarana Penunjang Kepelabuhanan (UPTD PP. Tenda);0;93900000;370000000;463900000
3.01 . 3.01.01 . 15;Program Pelayanan Sarana Produksi Perikanan (UPTD Pelabuhan Perikanan Gentuma);0;108200000;183800000;292000000
3.01 . 3.01.01 . 15 . 01;Peningkatan Mutu Pelayanan Kepelabuhanan (UPTD PP. Gentuma);0;98200000;43800000;142000000
3.01 . 3.01.01 . 15 . 02;Penyediaan Sarana Penunjang Kepelabuhanan (UPTD PP. Gentuma);0;10000000;140000000;150000000
3.01 . 3.01.01 . 17;Program Peningkatan Sarana/Prasarana dibidang Kelautan dan Perikanan (DAK);0;1982292780;8969909220;10952202000
3.01 . 3.01.01 . 17 . 01;Peningkatan Sarana dan Prasarana Perkantoran UPTD Pelabuhan Perikanan Tenda (DAK);0;0;524461570;524461570
3.01 . 3.01.01 . 17 . 02;Peningkatan Sarana dan Prasarana Perkantoran UPTD Pelabuhan Perikanan Gentuma (DAK);0;0;3649736663;3649736663
3.01 . 3.01.01 . 17 . 03;Peningkatan Sarana dan Prasarana Perkantoran UPTD-BPBLP (DAK);0;0;686167688;686167688
3.01 . 3.01.01 . 17 . 04;Pengembangan Budidaya Air Laut (DAK);0;0;693836864;693836864
3.01 . 3.01.01 . 17 . 05;Pengembangan Kawasan Konservasi Perairan (DAK);0;386897880;0;386897880
3.01 . 3.01.01 . 17 . 06;Pengembangan Sarana dan Prasarana Tambak Garam (DAK);0;1294474327;0;1294474327
3.01 . 3.01.01 . 17 . 07;Pengembangan Sarana dan Prasarana Pengawasan Pengelolaan Sumber Daya Kelautan dan Perikanan (DAK);0;0;621443972;621443972
3.01 . 3.01.01 . 17 . 08;Peningkatan Jaminan Mutu dan Daya Saing Komoditi Perikanan (DAK);0;300920573;0;300920573
3.01 . 3.01.01 . 17 . 09;Penguatan Sistem Logistik Ikan Nasional (DAK);0;0;2794262463;2794262463
03.02;Pariwisata;946350000;4948725864;3570837000;9465912864
3.02 . 3.02.01;DINAS PARIWISATA;946350000;4948725864;3570837000;9465912864
3.02 . 3.02.01 . 01;Peningkatan Pelayanan Administrasi, Sarana Prasarana dan SDM Aparatur;252120000;789193000;124250000;1165563000
3.02 . 3.02.01 . 01 . 01;Pelayanan Jasa Administrasi Perkantoran;252120000;324915000;0;577035000
3.02 . 3.02.01 . 01 . 02;Peningkatan Sarana dan Prasarana Perkantoran;0;374278000;124250000;498528000
3.02 . 3.02.01 . 01 . 03;Peningkatan Kapasitas Sumber Daya Aparatur;0;90000000;0;90000000
3.02 . 3.02.01 . 02;Peningkatan Perencanaan, Monitoring, Evaluasi dan Pelaporan;114840000;544541364;0;659381364
3.02 . 3.02.01 . 02 . 01;Perencanaan, Koordinasi, Monitoring dan Evaluasi;56760000;460147000;0;516907000
3.02 . 3.02.01 . 02 . 02;Penatausahaan dan Penyusunan Laporan Keuangan;58080000;84394364;0;142474364
3.02 . 3.02.01 . 15;Program Pengembangan Pemasaran Pariwisata;118710000;2565671500;0;2684381500
3.02 . 3.02.01 . 15 . 01;Pemasaran Pariwisata Dalam dan Luar Negeri;30360000;270960000;0;301320000
3.02 . 3.02.01 . 15 . 02;Promosi Potensi Pariwisata Dalam dan Luar Negeri;27720000;609415000;0;637135000
3.02 . 3.02.01 . 15 . 04;Pengembangan Promosi Seni Budaya Pariwisata;2550000;1186251500;0;1188801500
3.02 . 3.02.01 . 15 . 05;Pengelolaan Data dan Informasi Pariwisata;58080000;499045000;0;557125000
3.02 . 3.02.01 . 16;Program Pengembangan Destinasi dan Industri Pariwisata;399960000;507400000;0;907360000
3.02 . 3.02.01 . 16 . 01;Pengembangan Destinasi Pariwisata Provinsi;399960000;307400000;0;707360000
3.02 . 3.02.01 . 16 . 02;Pembinaan Industri Jasa Pariwisata;0;100000000;0;100000000
3.02 . 3.02.01 . 16 . 03;Perencanaan dan Pengelolaan Obyek Wisata berbasis Masyarakat;0;100000000;0;100000000
3.02 . 3.02.01 . 17;Program Pengembangan Ekonomi Kreatif, Kelembagaan dan SDM Pariwisata;60720000;541920000;0;602640000
3.02 . 3.02.01 . 17 . 01;Pengembangan Industri Kreatif Potensial;60720000;341920000;0;402640000
3.02 . 3.02.01 . 17 . 02;Penguatan Kelembagaan Kepariwisataan;0;100000000;0;100000000
3.02 . 3.02.01 . 17 . 03;Pengembangan SDM Pariwisata;0;100000000;0;100000000
3.02 . 3.02.01 . 18;Program Pengembangan Destinasi dan Industri Pariwisata (DAK Fisik Penugasan);0;0;3446587000;3446587000
3.02 . 3.02.01 . 18 . 01;Pembangunan Amenitas Kawasan (DAK Fisik Penugasan);0;0;2519869849;2519869849
3.02 . 3.02.01 . 18 . 02;Pembangunan Atraksi (Daya Tarik) (DAK Fisik Penugasan);0;0;926717151;926717151
03.03;Pertanian;6451042000;27451092924;13201725250;47103860174
3.03 . 3.03.01;DINAS PERTANIAN;6451042000;27451092924;13201725250;47103860174
3.03 . 3.03.01 . 01;Peningkatan Pelayanan Administrasi, Sarana Prasarana dan SDM Aparatur;625680000;4120705378;655000000;5401385378
3.03 . 3.03.01 . 01 . 01;Pelayanan Jasa Administrasi Perkantoran;479688000;1241652600;0;1721340600
3.03 . 3.03.01 . 01 . 06;Pelayanan Jasa Administrasi Perkantoran (UPTD Balai Perbibitan Ternak);20856000;285469200;0;306325200
3.03 . 3.03.01 . 01 . 08;Pelayanan Jasa Administrasi Perkantoran (UPTD Laboratorium Veteriner);0;260882000;0;260882000
3.03 . 3.03.01 . 01 . 11;Peningkatan Sarana dan Prasarana Perkantoran;0;315958203;655000000;970958203
3.03 . 3.03.01 . 01 . 12;Peningkatan Kapasitas SDM Aparatur;0;476525375;0;476525375
3.03 . 3.03.01 . 01 . 13;Pelayanan Jasa Administrasi Perkantoran (UPTD-BPPSBP);20856000;575190000;0;596046000
3.03 . 3.03.01 . 01 . 14;Pelayanan Jasa Administrasi Perkantoran (UPTD-Balitan);20856000;479776000;0;500632000
3.03 . 3.03.01 . 01 . 15;Pelayanan Jasa Administrasi Perkantoran (UPTD Balai Pelatihan Teknis Pertanian);83424000;485252000;0;568676000
3.03 . 3.03.01 . 02;Peningkatan Perencanaan, Monitoring, Evaluasi dan Pelaporan;566880000;1486286596;0;2053166596
3.03 . 3.03.01 . 02 . 01;Perencanaan, Koordinasi, Monitoring dan Evaluasi;145992000;832337375;0;978329375
3.03 . 3.03.01 . 02 . 02;Penatausahaan dan Penyusunan Laporan Keuangan;62568000;94560000;0;157128000
3.03 . 3.03.01 . 02 . 03;Penyusunan Data Satistik dan Sistem Informasi Pertanian;358320000;559389221;0;917709221
3.03 . 3.03.01 . 50;Peningkatan Nilai Tambah Hasil Pertanian;0;239250000;50250000;289500000
3.03 . 3.03.01 . 50 . 05;Promosi Produk Unggulan Pertanian;0;239250000;50250000;289500000
3.03 . 3.03.01 . 58;Program Peningkatan Produksi Tanaman Pertanian/ Populasi Ternak berkelanjutan;5067178000;18773442650;255089250;24095709900
3.03 . 3.03.01 . 58 . 01;Penyediaan Benih Padi dan Jagung;208560000;5164036000;0;5372596000
3.03 . 3.03.01 . 58 . 02;Penyediaan Benih Kacang-kacangan, umbi-umbian dan pupuk;0;47300000;0;47300000
3.03 . 3.03.01 . 58 . 03;Produksi Benih/Bibit Unggul Tanaman Pangan;243516000;66552000;0;310068000
3.03 . 3.03.01 . 58 . 04;Pengamatan, Peramalan dan Pengendalian OPT Tanaman Pangan;274185000;293795000;0;567980000
3.03 . 3.03.01 . 58 . 05;Pengawasan Mutu dan sertifikasi Benih Tanaman Pangan;293859000;58388700;0;352247700
3.03 . 3.03.01 . 58 . 06;Penyediaan Benih Sayuran, Biofarmaka dan Pupuk;104280000;137984000;0;242264000
3.03 . 3.03.01 . 58 . 08;Penyediaan Benih/Bibit Unggul Hortikultura;229416000;72456000;0;301872000
3.03 . 3.03.01 . 58 . 09;Pengamatan, Peramalan dan Pengendalian OPT Hortikultura;128928000;77060000;0;205988000
3.03 . 3.03.01 . 58 . 10;Pengawasan Mutu dan Sertifikasi Benih /Bibit Hortikultura;132636000;47743300;0;180379300
3.03 . 3.03.01 . 58 . 11;Penyediaan Benih/Bibit Tanaman Semusim, Rempah dan Pupuk;125136000;11328000;0;136464000
3.03 . 3.03.01 . 58 . 12;Penyediaan Benih/Bibit Tanaman Tahunan , Penyegar dan Pupuk;125136000;267900000;0;393036000
3.03 . 3.03.01 . 58 . 14;Penyediaan Pakan Ternak;62568000;302250000;0;364818000
3.03 . 3.03.01 . 58 . 15;Pengendalian dan Penanggulangan Penyakit Hewan Menular Strategis;333696000;120000000;0;453696000
3.03 . 3.03.01 . 58 . 16;Penyediaan Bibit Ternak;646536000;7490905500;0;8137441500
3.03 . 3.03.01 . 58 . 17;Produksi Bibit Ternak Ruminansia;398160000;558965550;123589250;1080714800
3.03 . 3.03.01 . 58 . 18;Produksi Bibit Ternak Non Ruminansia;341280000;1039535700;0;1380815700
3.03 . 3.03.01 . 58 . 19;Pengadaan Sarana Pasca Panen Tanaman Pangan;110424000;216150000;100000000;426574000
3.03 . 3.03.01 . 58 . 20;Pengadaan Sarana Pasca Panen Hortikultura;62568000;125350000;0;187918000
3.03 . 3.03.01 . 58 . 21;Survey Pengolahan Lahan dan Air;62568000;75782000;0;138350000
3.03 . 3.03.01 . 58 . 22;Penyediaan Sarana Prasarana Produksi dan Alsintan;233424000;590516000;0;823940000
3.03 . 3.03.01 . 58 . 23;Pelayanan Brigade Alsintan;104280000;1018242000;31500000;1154022000
3.03 . 3.03.01 . 58 . 24;Advokasi kepesertaan Asuransi;41712000;139360000;0;181072000
3.03 . 3.03.01 . 58 . 25;Diagnosa dan Penyidikan secara Cepat, Tepat dan Akurat terhadap Gejala Penyakit Hewan Menular;104280000;181620000;0;285900000
3.03 . 3.03.01 . 58 . 26;Penyelenggaraan Penyuluhan Pertanian;83424000;53434000;0;136858000
3.03 . 3.03.01 . 58 . 27;Pembinaan Kelompok Tani;83424000;360255000;0;443679000
3.03 . 3.03.01 . 58 . 28;Penguatan Ketenagaan Penyuluh Pertanian;279118000;72775000;0;351893000
3.03 . 3.03.01 . 58 . 31;Penyediaan Benih Unggul Tanaman Perkebunan;191496000;46508900;0;238004900
3.03 . 3.03.01 . 58 . 32;Penyediaan Benih Buah, Tanaman Hias dan Pupuk;62568000;137250000;0;199818000
3.03 . 3.03.01 . 59;Program Pengembangan SDM Pertanian;125136000;148083300;0;273219300
3.03 . 3.03.01 . 59 . 01;Pengembangan SDM Pelaku Utama dan Pelaku Usaha;125136000;148083300;0;273219300
3.03 . 3.03.01 . 63;Rural Empowerment and Agricultural Development-Scaling UP Initiative (READSI);3600000;2467893000;0;2471493000
3.03 . 3.03.01 . 63 . 01;Rural Empowerment and Agricultural Development-Scaling UP Initiative (READSI);3600000;2467893000;0;2471493000
3.03 . 3.03.01 . 64;Pembangunan/Renovasi UPTD/Balai Perbenihan, Proteksi, Perbibitan Tanaman Pangan, Hortikultura, Perkebunan dan Peternakan serta Sarana Pendukungnya;0;0;12241386000;12241386000
3.03 . 3.03.01 . 64 . 02;Pembangunan/Renovasi UPTD/Balai Proteksi Tanaman Pangan dan Hortikultura serta Sarana Pendukunya;0;0;12241386000;12241386000
3.03 . 3.03.01 . 65;Program Penyediaan Asal Hewan Yang Aman, Sehat, Utuh dan Halal (PAH ASUH);62568000;215432000;0;278000000
3.03 . 3.03.01 . 65 . 01;Penyediaan PAH-ASUH dan Jaminan Kemanan PAH;41712000;27945000;0;69657000
3.03 . 3.03.01 . 65 . 02;Diagnosa dan Penyidikan secara Cepat, Tepat dan Akurat terhadap  Pangan Asal Hewan  (Daging, SUsu, Telur);20856000;187487000;0;208343000
03.04;Kehutanan;4040615000;7163048641;2489092000;13692755641
3.04 . 2.05.01;DINAS LINGKUNGAN HIDUP DAN KEHUTANAN;4040615000;7163048641;2489092000;13692755641
3.04 . 2.05.01 . 21;Program Rehabilitasi dan Perlindungan Lingkungan Hidup dan Kehutanan;295905000;714798000;1169092000;2179795000
3.04 . 2.05.01 . 21 . 03;Rehabilitasi Hutan dan Lahan Pada DAS Prioritas;64815000;35185000;0;100000000
3.04 . 2.05.01 . 21 . 04;Penyiapan dan Pengembangan Usaha Perhutanan Sosial;48600000;51400000;0;100000000
3.04 . 2.05.01 . 21 . 05;Pencegahan dan Pengendalian Kebakaran Hutan;0;50000000;0;50000000
3.04 . 2.05.01 . 21 . 06;Operasi Pengamanan & Perlindungan Hutan;0;100000000;0;100000000
3.04 . 2.05.01 . 21 . 07;Penyiapan Kawasan Ekosistem Esensial (KEE);58080000;41920000;0;100000000
3.04 . 2.05.01 . 21 . 14;Rehabilitasi Hutan dan Lahan pada DAS Lemito dan Popayato;72030000;208321500;0;280351500
3.04 . 2.05.01 . 21 . 15;Rehabilitasi Hutan dan Lahan pada DAS Tilamuta;0;0;389697333;389697333
3.04 . 2.05.01 . 21 . 16;Rehabilitasi Hutan dan Lahan pada DAS Bone;0;0;389697334;389697334
3.04 . 2.05.01 . 21 . 17;Rehabilitasi Hutan dan Lahan pada DAS Randangan dan Marisa;0;0;389697333;389697333
3.04 . 2.05.01 . 21 . 18;Rehabilitasi Hutan dan Lahan pada DAS Sumalata;52380000;227971500;0;280351500
3.04 . 2.05.01 . 22;Program Pemanfaatan Potensi Sumber Daya Hutan;366290000;1441670641;0;1807960641
3.04 . 2.05.01 . 22 . 01;Pengawasan dan Pengendalian Penatausahaan dan Peredaran Hasil Hutan;85800000;71560641;0;157360641
3.04 . 2.05.01 . 22 . 02;Pengawasan dan Pengendalian Penatagunaan Kawasan Hutan;85800000;284800000;0;370600000
3.04 . 2.05.01 . 22 . 03;Verifikasi Izin Pemanfaatan Hutan (IPHHK/IPHHBK/IUIPHHK/Izin Pemanfaatan Kawasan Hutan);84420000;165580000;0;250000000
3.04 . 2.05.01 . 22 . 10;Pemberdayaan Masyarakat dalam Rehabilitasi Hutan dan Lahan di Wilayah KPH I & II Gorontalo Barat;0;200000000;0;200000000
3.04 . 2.05.01 . 22 . 11;Pemberdayaan Masyarakat dalam Rehabilitasi Hutan dan Lahan di Wilayah KPH III Pohuwato;0;200000000;0;200000000
3.04 . 2.05.01 . 22 . 12;Pemberdayaan Masyarakat dalam Rehabilitasi Hutan dan Lahan di WIlayah KPH IV Gorontalo Utara;45470000;154530000;0;200000000
3.04 . 2.05.01 . 22 . 13;Pemberdayaan Masyarakat dalam Rehabilitasi Hutan dan Lahan di WIlayah KPH V Boalemo;0;200000000;0;200000000
3.04 . 2.05.01 . 22 . 14;Pemberdayaan Masyarakat dalam Rehabilitasi Hutan dan Lahan di WIlayah KPH VI Gorontalo;16800000;13200000;0;30000000
3.04 . 2.05.01 . 22 . 15;Pemberdayaan Masyarakat dalam Rehabilitasi Hutan dan Lahan di WIlayah KPH VII Bone Bolango dan Kota Gorontalo;48000000;152000000;0;200000000
3.04 . 2.05.01 . 23;Program  Penegakan Hukum Lingkungan dan Kehutanan;0;30000000;0;30000000
3.04 . 2.05.01 . 23 . 01;Pemantauan dan Pengawasan Bidang Lingkungan Hidup dan Kehutanan;0;30000000;0;30000000
3.04 . 2.05.01 . 24;Program Rehabilitasi dan Perlindungan Lingkungan Hidup dan Kehutanan (DAK FISIK);3378420000;4976580000;1320000000;9675000000
3.04 . 2.05.01 . 24 . 01;Hutan Manunggal (DAK FISIK);1562490000;1207120000;0;2769610000
3.04 . 2.05.01 . 24 . 02;Pembuatan Areal Model Agroforestri dan Hutan Rakyat (DAK FISIK);0;1750000000;0;1750000000
3.04 . 2.05.01 . 24 . 03;Rehabilitasi Hutan dan Lahan Pada DAS Prioritas (DAK FISIK);1562490000;1042900000;0;2605390000
3.04 . 2.05.01 . 24 . 04;Kelola Kawasan Perhutanan Sosial (DAK FISIK);0;300000000;0;300000000
3.04 . 2.05.01 . 24 . 05;Operasi Pengamanan dan Perlindungan Hutan (DAK FISIK);0;180000000;1320000000;1500000000
3.04 . 2.05.01 . 24 . 10;Peningkatan Produktivitas Hutan dan Lahan di UPTD KPH Unit VI Gorontalo (DAK FISIK);253440000;496560000;0;750000000
03.05;Energi dan Sumberdaya Mineral;524680000;6205735000;0;6730415000
3.05 . 2.12.01;DINAS PENANAMAN MODAL, ESDM DAN TRANSMIGRASI;524680000;6205735000;0;6730415000
3.05 . 2.12.01 . 15;Program Pengelolaaan Pertambangan Mineral;58080000;361920000;0;420000000
3.05 . 2.12.01 . 15 . 13;Pembinaan dan Pengawasan Usaha Pertambangan;58080000;361920000;0;420000000
3.05 . 2.12.01 . 17;Program Pembinaan dan Pengembangan Bidang Energi dan Ketenagalistrikan;113520000;4931015000;0;5044535000
3.05 . 2.12.01 . 17 . 04;Pengembangan Energi Baru Terbarukan;30360000;296450000;0;326810000
3.05 . 2.12.01 . 17 . 05;Pengembangan Ketenagalistrikan Daerah;55440000;2415810000;0;2471250000
3.05 . 2.12.01 . 17 . 09;Pengadaan dan Pemasangan Lampu Penerangan Jalan Umum;0;2095425000;0;2095425000
3.05 . 2.12.01 . 17 . 10;Pengawasan Ketersediaan Energi;27720000;123330000;0;151050000
3.05 . 2.12.01 . 19;Program Penyelidikan Pelayanan,Pembinaan dan Pengawasan Pengendalian Air Tanah;324040000;730850000;0;1054890000
3.05 . 2.12.01 . 19 . 01;Pemanfaatan Potensi Air Tanah;324040000;625850000;0;949890000
3.05 . 2.12.01 . 19 . 02;Pembinaan dan Pengawasan Air Tanah;0;105000000;0;105000000
3.05 . 2.12.01 . 20;Penyelidikan dan Pelayanan Geologi;29040000;181950000;0;210990000
3.05 . 2.12.01 . 20 . 01;Penyelidikan Geologi Teknik untuk menunjang Infrastruktur;29040000;181950000;0;210990000
03.06;Perdagangan;30360000;9062115000;5030000000;14122475000
3.06 . 2.11.01;DINAS KOPERASI, UKM, PERINDUSTRIAN DAN PERDAGANGAN;30360000;9062115000;5030000000;14122475000
3.06 . 2.11.01 . 15;Program Pengembangan dan Pengamanan Perdagangan Dalam Negeri;30360000;8465140000;0;8495500000
3.06 . 2.11.01 . 15 . 02;Stabilisasi Harga Kebutuhan Pokok dan Barang Strategis;30360000;8315140000;0;8345500000
3.06 . 2.11.01 . 15 . 03;Peningkatan Pengawasan Peredaran Barang dan Jasa;0;61875000;0;61875000
3.06 . 2.11.01 . 15 . 04;Penyelesaian Pengaduan dan Sengketa Konsumen;0;88125000;0;88125000
3.06 . 2.11.01 . 17;Program Peningkatan dan Pengembangan Ekspor Daerah;0;102000000;0;102000000
3.06 . 2.11.01 . 17 . 01;Promosi dan Pengembangan Produk Ekspor Daerah;0;102000000;0;102000000
3.06 . 2.11.01 . 20;Program Peningkatan Standarisasi Mutu Barang;0;494975000;280000000;774975000
3.06 . 2.11.01 . 20 . 02;Pengujian dan Sertifikasi Mutu Barang;0;329400000;280000000;609400000
3.06 . 2.11.01 . 20 . 03;Penerapan Standarisasi Mutu Barang;0;165575000;0;165575000
3.06 . 2.11.01 . 21;Pelayanan Administrasi, Sarana Prasarana dan SDM Aparatur (DAK Fisik Penugasan);0;0;4750000000;4750000000
3.06 . 2.11.01 . 21 . 01;Peningkatan Sarana dan Prasarana UPTD BPSMB (DAK Fisik Penugasan);0;0;4750000000;4750000000
03.07;Perindustrian;234150000;849008800;0;1083158800
3.07 . 2.11.01;DINAS KOPERASI, UKM, PERINDUSTRIAN DAN PERDAGANGAN;234150000;849008800;0;1083158800
3.07 . 2.11.01 . 16;Program Pengembangan Industri Kecil dan Menengah;234150000;849008800;0;1083158800
3.07 . 2.11.01 . 16 . 01;Pengembangan Agro Industri & Industri Pangan Daerah;56970000;243030000;0;300000000
3.07 . 2.11.01 . 16 . 02;Pembinaan Teknologi Industri Kimia, Kerajinan, Sandang dan Aneka;90300000;284550000;0;374850000
3.07 . 2.11.01 . 16 . 03;Pembinaan Teknologi Industri Logam, Mesin dan Elektronik;1080000;115160000;0;116240000
3.07 . 2.11.01 . 16 . 04;Pengembangan Sistem Informasi IKM;0;154268800;0;154268800
3.07 . 2.11.01 . 16 . 05;Pengembangan Agro Industri Terpadu;85800000;52000000;0;137800000
03.08;Transmigrasi;179520000;391050000;0;570570000
3.08 . 2.12.01;DINAS PENANAMAN MODAL, ESDM DAN TRANSMIGRASI;179520000;391050000;0;570570000
3.08 . 2.12.01 . 15;Program Pembangunan dan Pengembangan Kawasan Transmigrasi;58080000;200430000;0;258510000
3.08 . 2.12.01 . 15 . 06;Pembangunan dan Pengembangan Sarana dan Prasarana di Kawasan Transmigrasi;58080000;200430000;0;258510000
3.08 . 2.12.01 . 22;Program Pengembangan Masyarakat di Kawasan Transmigrasi;121440000;190620000;0;312060000
3.08 . 2.12.01 . 22 . 01;Pembinaan Enonomi, Sosial Budaya, dan Mental Spiritual bagi warga transmigrasi;121440000;190620000;0;312060000
4;Urusan Pemerintahan Fungsi Penunjang;17490700000;151170742275;10360015627;179021457902
04.01;Administrasi Pemerintahan;11969450000;113714356271;7560901627;133244707898
4.01 . 4.01.03;SEKRETARIAT DAERAH;8490950000;54917347412;5074258227;68482555639
4.01 . 4.01.03 . 01;Peningkatan Pelayanan Administrasi, Sarana dan Prasarana serta Sumber Daya Aparatur;3308840000;9203565969;3908758227;16421164196
4.01 . 4.01.03 . 01 . 02;Pelayanan Jasa Administrasi Perkantoran (Biro Umum);921840000;804831677;0;1726671677
4.01 . 4.01.03 . 01 . 03;Pelayanan Jasa Administrasi Perkantoran (Biro Humas dan Protokol);637560000;324970000;0;962530000
4.01 . 4.01.03 . 01 . 04;Pelayanan Jasa Administrasi Perkantoran (Biro Pemerintahan dan Kesra);274560000;112840000;0;387400000
4.01 . 4.01.03 . 01 . 05;Pelayanan Jasa Administrasi Perkantoran (Biro Pengendalian Pembangunan dan Ekonomi);179520000;199799000;0;379319000
4.01 . 4.01.03 . 01 . 06;Pelayanan Jasa Administrasi Perkantoran (Biro Hukum dan Organisasi);66240000;324230000;85000000;475470000
4.01 . 4.01.03 . 01 . 07;Pelayanan Jasa Administrasi Perkantoran (Biro Pengadaan);377520000;271355000;0;648875000
4.01 . 4.01.03 . 01 . 09;Peningkatan Sarana dan Prasarana Perkantoran (Biro Umum);0;1174350000;3080030227;4254380227
4.01 . 4.01.03 . 01 . 10;Peningkatan Sarana dan Prasarana Perkantoran (Biro Humas dan Protokol);0;573100000;376250000;949350000
4.01 . 4.01.03 . 01 . 11;Peningkatan Sarana dan Prasarana Perkantoran (Biro Pemerintahan dan Kesra);0;71922000;28078000;100000000
4.01 . 4.01.03 . 01 . 12;Peningkatan Sarana dan Prasarana Perkantoran (Biro Pengendalian Pembangunan dan Ekonomi);0;37400000;19850000;57250000
4.01 . 4.01.03 . 01 . 13;Peningkatan Sarana dan Prasarana Perkantoran (Biro Hukum dan Organisasi);63360000;129040000;0;192400000
4.01 . 4.01.03 . 01 . 14;Peningkatan Sarana dan Prasarana Perkantoran (Biro Pengadaan);0;118530000;319550000;438080000
4.01 . 4.01.03 . 01 . 15;Peningkatan Kapasitas SDM Aparatur;0;565360400;0;565360400
4.01 . 4.01.03 . 01 . 16;Pemeliharaan Gedung/Peralatan Kantor;758000000;3098871752;0;3856871752
4.01 . 4.01.03 . 01 . 17;Pemeliharaan Kendaraan Dinas Operasional;0;1000106140;0;1000106140
4.01 . 4.01.03 . 01 . 27;Peningkatan Kapasitas SDM Aparatur (Biro Pengendalian Pembangunan dan Ekonomi);0;103050000;0;103050000
4.01 . 4.01.03 . 01 . 28;Peningkatan Kapasitas SDM Aparatur (Biro Hukum dan Organisasi);30240000;104760000;0;135000000
4.01 . 4.01.03 . 01 . 29;Peningkatan Kapasitas SDM Aparatur (Biro Pengadaan);0;189050000;0;189050000
4.01 . 4.01.03 . 02;Program Peningkatan Perencanaan, Koordinasi, Monitoring Dan Evaluasi;33120000;1725182067;0;1758302067
4.01 . 4.01.03 . 02 . 01;Perencanaan, Koordinasi, Monitoring dan Evaluasi;33120000;845266067;0;878386067
4.01 . 4.01.03 . 02 . 01;Prencanaan, Koordinasi, Monitoring dan Evaluasi;0;281918000;0;281918000
4.01 . 4.01.03 . 02 . 02;Penatausahaan dan Penyusunan Laporan Keuangan;0;165000000;0;165000000
4.01 . 4.01.03 . 02 . 02;Penatausahaan Laporan Keuangan;0;139750000;0;139750000
4.01 . 4.01.03 . 02 . 25;Perencanaan, Koordinasi, Monitoring dan Evaluasi (BIro Pengendalian Pembangunan dan Ekonomi);0;293248000;0;293248000
4.01 . 4.01.03 . 04;Pembinaan Atas Penyelenggaraan Pemerintahan Daerah;0;807410000;0;807410000
4.01 . 4.01.03 . 04 . 07;Koordinasi/Konsultasi Penyelenggaraan Pemerintahan dengan Pemerintah Pusat, Pemerintah Daerah, Provinsi, Instansi Vertikal dan Pemda Kabupaten/Kota;0;200000000;0;200000000
4.01 . 4.01.03 . 04 . 08;Pelayanan Administrasi Pengangkatan dan Pemberhentian Kepala Daerah/Wakil Kepala Daerah dan DPRD;0;140000000;0;140000000
4.01 . 4.01.03 . 04 . 09;Pelayanan Aparatur Pemerintah Pusat dan Daerah Lainnya, Legislatif (DPR RI, DPD RI dan DPRD);0;100000000;0;100000000
4.01 . 4.01.03 . 04 . 10;Penyusunan Standar Pelayanan Minimal;0;187410000;0;187410000
4.01 . 4.01.03 . 04 . 11;Penyusunan Laporan Penyelenggaraan Pemerintahan Daerah dan Layanan Iuran APPSI;0;180000000;0;180000000
4.01 . 4.01.03 . 05;Program Peningkatan Pelayanan Kedinasan Kepala Daerah/Wakil Kepala Daerah Kedianasan Pemerintah Provinsi Gorontalo;0;1399089713;0;1399089713
4.01 . 4.01.03 . 05 . 01;Koordinasi dengan Pemerintah Pusat dan Pemerintah Daerah Lainnya;0;374253000;0;374253000
4.01 . 4.01.03 . 05 . 02;Peningkatan Pelayanan Kedinasan Pemerintah Provinsi Gorontalo;0;684800000;0;684800000
4.01 . 4.01.03 . 05 . 03;Monitoring Aset dan Bantuan Barang Hibah;0;173350000;0;173350000
4.01 . 4.01.03 . 05 . 04;Penatausahaan dan Penyusunan Dokumen Aset;0;166686713;0;166686713
4.01 . 4.01.03 . 15;Penataan Wilayah Provinsi;0;360869579;160000000;520869579
4.01 . 4.01.03 . 15 . 01;Penetapan dan Pemasangan Tugu/Pilar Batas Antar Daerah dan Fasilitasi Perselisihan Batas Antar Daerah;0;100000000;160000000;260000000
4.01 . 4.01.03 . 15 . 02;Pendataan dan Penamaan Rupa Bumi (Toponimi);0;50000000;0;50000000
4.01 . 4.01.03 . 15 . 03;Koordinasi Evaluasi Pelaksanaan Dekonsentrasi dan Tugas Pembantuan dan Koordinasi PATEN;0;143450000;0;143450000
4.01 . 4.01.03 . 15 . 04;Koordinasi Penyelenggaraan Pemerintahan Daerah dengan Instansi Vertikal dan Pemerintah Kab/Kota se Provinsi Gorontalo;0;67419579;0;67419579
4.01 . 4.01.03 . 17;Penataan Peraturan Perundang-Undangan;132365000;342635000;0;475000000
4.01 . 4.01.03 . 17 . 01;Pengkajian dan Pendampingan Ranperda;33120000;88970000;0;122090000
4.01 . 4.01.03 . 17 . 02;Pengkajian Peraturan dan Keputusan Kepala Daerah;33120000;82050000;0;115170000
4.01 . 4.01.03 . 17 . 03;Sosialisasi dan Publikasi Peraturan Perundang-Undangan;66125000;133875000;0;200000000
4.01 . 4.01.03 . 17 . 04;Konsultasi Publik Rancangan Produk Hukum Daerah;0;37740000;0;37740000
4.01 . 4.01.03 . 18;Pendampingan, Layanan dan  Penyelenggaraan  Bantuan Hukum;28800000;1606850000;0;1635650000
4.01 . 4.01.03 . 18 . 01;Pendampingan dan Penyelesaian Sengketa Hukum;28800000;860695000;0;889495000
4.01 . 4.01.03 . 18 . 02;Bantuan Hukum Bagi Masyarakat Miskin;0;153180000;0;153180000
4.01 . 4.01.03 . 18 . 03;Pelayanan Hukum Terpadu melalui Sidang Itsbat Nikah Mobile;0;515525000;0;515525000
4.01 . 4.01.03 . 18 . 04;Penguatan Peran Organisasi Bantuan Hukum Se-Provinsi Gorontalo;0;77450000;0;77450000
4.01 . 4.01.03 . 19;Penataan Memorandum of Understanding dan Perjanjian Kerjasama;30240000;136960000;0;167200000
4.01 . 4.01.03 . 19 . 01;Monitoring dan Evaluasi Pelaksanaan Pemenuhan Prestasi Kerjasama Daerah;30240000;136960000;0;167200000
4.01 . 4.01.03 . 20;Pembinaan Penyidik Pegawai Negeri Sipil dan Pemajuan Hak Asasi Manusia (HAM);0;192050000;0;192050000
4.01 . 4.01.03 . 20 . 01;Koordinasi dan Konsolidasi Data PPNS Provinsi Kabupaten/ Kota serta Pendataan Rencana Aksi Hak Asasi Manusia Provinsi Gorontalo;0;192050000;0;192050000
4.01 . 4.01.03 . 22;Penataan Kelembagaan Perangkat Daerah;60480000;739520000;0;800000000
4.01 . 4.01.03 . 22 . 01;Pembentukan, Penyempurnaan, dan Pembubaran Perangkat Daerah;60480000;739520000;0;800000000
4.01 . 4.01.03 . 23;Peningkatan Sistem Akuntabilitas Kinerja Instansi Pemerintah;36320000;535180000;0;571500000
4.01 . 4.01.03 . 23 . 01;Penguatan Sistem Akuntabilitas Kinerja Instansi Pemerintah dan Reformasi Birokrasi;34720000;280780000;0;315500000
4.01 . 4.01.03 . 23 . 02;Koordinasi, Sinkronisasi dan Konsolidasi Data Kinerja Instansi Pemerintah;1600000;254400000;0;256000000
4.01 . 4.01.03 . 24;Penyusunan Dokumen dan Penyelenggaraan Pelayanan Publik;1600000;198400000;0;200000000
4.01 . 4.01.03 . 24 . 02;Penetapan dan Evaluasi Standar Operasional Prosedur (SOP);800000;99200000;0;100000000
4.01 . 4.01.03 . 24 . 03;Layanan Keikutsertaan Pada Kompetisi Inovasi Pelayanan Publik;800000;99200000;0;100000000
4.01 . 4.01.03 . 26;Peningkatan Pelayanan Kegiatan Keagamaan, Adat dan Budaya;273390000;10280360000;0;10553750000
4.01 . 4.01.03 . 26 . 01;Pelayanan Penyelenggaraan Ibadah Haji Yang Belum Memiliki Embarkasi/Embarkasi Haji Antara (EHA) Provinsi Gorontalo;154800000;5327160000;0;5481960000
4.01 . 4.01.03 . 26 . 02;Penyelenggaraan Kegiatan Hari-hari Besar Keagamaan;0;680250000;0;680250000
4.01 . 4.01.03 . 26 . 03;Pembinaan dan Pelayanan Keagamaan;81840000;2694700000;0;2776540000
4.01 . 4.01.03 . 26 . 04;Penyelenggaraan MTQ,STQ Tingkat Prov, TC , MTQ,STQ Dan Keikutsertaan Kafilah Prov. Gtlo Di Tingkat Nasional;0;815000000;0;815000000
4.01 . 4.01.03 . 26 . 05;Pelaksanaan Kegiatan Adat dan Budaya;36750000;63250000;0;100000000
4.01 . 4.01.03 . 26 . 06;Pembiayaan Umroh Bagi Masyarakat;0;700000000;0;700000000
4.01 . 4.01.03 . 27;Pengendalian Pembangunan;59400000;699809000;0;759209000
4.01 . 4.01.03 . 27 . 03;Peningkatan Kualitas Pengendalian Pembangunan;0;361000000;0;361000000
4.01 . 4.01.03 . 27 . 04;Konsolidasi, Monitoring dan Evaluasi Pembangunan;59400000;338809000;0;398209000
4.01 . 4.01.03 . 28;Pengendalian Ekonomi;60720000;491284000;0;552004000
4.01 . 4.01.03 . 28 . 02;Koordinasi Bidang Ekonomi;60720000;145984000;0;206704000
4.01 . 4.01.03 . 28 . 03;Pengendalian Bidang Ekonomi;0;345300000;0;345300000
4.01 . 4.01.03 . 32;Peningkatan Layanan Pengadaan;0;705350000;0;705350000
4.01 . 4.01.03 . 32 . 01;Pengembangan Strategi Kebijakan dan Penerapan Regulasi PBJP;0;217772000;0;217772000
4.01 . 4.01.03 . 32 . 02;Pengembangan LPSE dan Informasi;0;124157500;0;124157500
4.01 . 4.01.03 . 32 . 03;Klarifikasi, Verifikasi dan Koordinasi PBJP;0;236600000;0;236600000
4.01 . 4.01.03 . 32 . 05;Pengelolaan Layanan Konsultasi PBJP;0;126820500;0;126820500
4.01 . 4.01.03 . 34;Peningkatan Kapasitas Aparatur Pemerintah Desa/Kelurahan;0;106550000;0;106550000
4.01 . 4.01.03 . 34 . 03;Pembinaan Aparatur Pemerintahan Desa dan Kelurahan;0;106550000;0;106550000
4.01 . 4.01.03 . 39;Program Peningkatan Pelayanan Kedinasan Kepala Daerah/ Wakil Kepala Daerah;0;701937558;0;701937558
4.01 . 4.01.03 . 39 . 01;Pelayanan Keprotokolan Pemerintah Dalam Daerah;0;461937558;0;461937558
4.01 . 4.01.03 . 39 . 02;Pelayanan Keprotokolan Pemerintah Luar Daerah;0;240000000;0;240000000
4.01 . 4.01.03 . 40;Program Peningkatan Pelayanan Kedinasan;3854635000;20892329526;1005500000;25752464526
4.01 . 4.01.03 . 40 . 01;Pelayanan Umum Kedinasan Kepala Daerah (Gubernur);0;4808732529;125000000;4933732529
4.01 . 4.01.03 . 40 . 02;Pelayanan Umum Rumah Tangga Kepala Daerah (Gubernur);1334960000;1946265000;409500000;3690725000
4.01 . 4.01.03 . 40 . 03;Pelayanan Umum Kedinasan Wakil Kepala Daerah (Wakil Gubernur);0;2667000000;58000000;2725000000
4.01 . 4.01.03 . 40 . 04;Pelayanan Umum Rumah Tangga Wakil Kepala Daerah (Wakil Gubernur);1066575000;1589662000;265000000;2921237000
4.01 . 4.01.03 . 40 . 05;Pelayanan Kegiatan Kedinasan Pemerintahan Provinsi Gorontalo;1403100000;8671556001;148000000;10222656001
4.01 . 4.01.03 . 40 . 06;Pelayanan Umum Kegiatan Pemerintahan Provinsi;50000000;1209113996;0;1259113996
4.01 . 4.01.03 . 41;Program Peningkatan Kualitas Pelayanan Informasi;611040000;3792015000;0;4403055000
4.01 . 4.01.03 . 41 . 01;Kerjasama dengan media masa dan media lainnya;0;2242000000;0;2242000000
4.01 . 4.01.03 . 41 . 02;Peliputan, Publikasi dan Dokumentasi Kebijakan pembangunan Pemerintah Daerah;0;828710000;0;828710000
4.01 . 4.01.03 . 41 . 03;Penyebarluasan informasi melalui Radio Suara Rakyat Hulondalo;611040000;721305000;0;1332345000
4.01 . 4.01.04;SEKRETARIAT DPRD;1262700000;54815351300;1834143400;57912194700
4.01 . 4.01.04 . 01;Peningkatan Pelayanan Administrasi, Sarana dan Prasarana serta Sumber Daya Aparatur;532620000;3790842000;1834143400;6157605400
4.01 . 4.01.04 . 01 . 01;Pelayanan Jasa Administrasi Perkantoran;388560000;621340000;0;1009900000
4.01 . 4.01.04 . 01 . 08;Peningkatan Sarana dan Prasarana Perkantoran;144060000;2858542000;1834143400;4836745400
4.01 . 4.01.04 . 01 . 15;Peningkatan Kapasitas SDM Aparatur;0;310960000;0;310960000
4.01 . 4.01.04 . 02;Program Peningkatan Perencanaan, Koordinasi, Monitoring Dan Evaluasi;0;465871800;0;465871800
4.01 . 4.01.04 . 02 . 01;Perencanaan, Koordinasi, Monitoring dan Evaluasi;0;174850000;0;174850000
4.01 . 4.01.04 . 02 . 02;Penatausahaan dan Penyusunan Laporan Keuangan;0;291021800;0;291021800
4.01 . 4.01.04 . 05;Program Peningkatan Pelayanan Kedinasan Kepala Daerah/Wakil Kepala Daerah Kedianasan Pemerintah Provinsi Gorontalo;0;1162910000;0;1162910000
4.01 . 4.01.04 . 05 . 01;Koordinasi dengan Pemerintah Pusat dan Pemerintah Daerah Lainnya;0;1162910000;0;1162910000
4.01 . 4.01.04 . 30;Peningkatan Pelayanan Kehumasan;96720000;2313650000;0;2410370000
4.01 . 4.01.04 . 30 . 01;Pelayanan Umum Kehumasan;96720000;2027700000;0;2124420000
4.01 . 4.01.04 . 30 . 02;Pelayanan Protokol dan Aspirasi;0;285950000;0;285950000
4.01 . 4.01.04 . 31;Peningkatan Kapasitas Lembaga Perwakilan Rakyat Daerah;633360000;47082077500;0;47715437500
4.01 . 4.01.04 . 31 . 01;Pembahasan Rancangan Peraturan Daerah;31200000;9270360000;0;9301560000
4.01 . 4.01.04 . 31 . 02;Hearing/DIalog dan Koordinasi dengan Pejabat Pemerintah Daerah dan Tokoh Masyarakat/Tokoh Agama;0;1026900000;0;1026900000
4.01 . 4.01.04 . 31 . 03;Rapat-rapat Alat Kelengkapan Dewan;602160000;597880000;0;1200040000
4.01 . 4.01.04 . 31 . 04;Rapat-rapat Paripurna;0;468050000;0;468050000
4.01 . 4.01.04 . 31 . 05;Kegiatan Reses;0;5930212500;0;5930212500
4.01 . 4.01.04 . 31 . 06;Kunjungan Kerja Pimpinan dan Anggota DPRD Dalam Daerah;0;2975800000;0;2975800000
4.01 . 4.01.04 . 31 . 07;Peningkatan Kapasitas Pimpinan dan Anggota DPRD;0;26415700000;0;26415700000
4.01 . 4.01.04 . 31 . 08;Sosialisasi Peraturan Perundang-undangan;0;397175000;0;397175000
4.01 . 4.01.08;BADAN PENGHUBUNG;1669800000;3028040000;36500000;4734340000
4.01 . 4.01.08 . 01;Peningkatan Pelayanan Administrasi, Sarana dan Prasarana serta Sumber Daya Aparatur;1391040000;1750320000;0;3141360000
4.01 . 4.01.08 . 01 . 01;Pelayanan Jasa Administrasi Perkantoran;1391040000;468230000;0;1859270000
4.01 . 4.01.08 . 01 . 08;Peningkatan Sarana dan Prasarana Perkantoran;0;698350000;0;698350000
4.01 . 4.01.08 . 01 . 15;Peningkatan Kapasitas SDM Aparatur;0;68410000;0;68410000
4.01 . 4.01.08 . 01 . 16;Pemeliharaan Gedung/Peralatan Kantor;0;295600000;0;295600000
4.01 . 4.01.08 . 01 . 22;Rapat-rapat Koordinasi dan Konsultasi Keluar Daerah;0;219730000;0;219730000
4.01 . 4.01.08 . 02;Program Peningkatan Perencanaan, Koordinasi, Monitoring Dan Evaluasi;0;85600000;0;85600000
4.01 . 4.01.08 . 02 . 02;Penatausahaan dan Penyusunan Laporan Keuangan;0;85600000;0;85600000
4.01 . 4.01.08 . 03;Program Peningkatan Pelayanan Kedinasan Kepala Daerah/Wakil Kepala Daerah serta Tamu VIP/VVIP;278760000;1192120000;36500000;1507380000
4.01 . 4.01.08 . 03 . 11;Pelayanan pada Kantor Penghubung Makassar;278760000;531120000;36500000;846380000
4.01 . 4.01.08 . 03 . 17;Peningkatan Pelayanan Keprotokolan kepada Unsur Pemerintah Eksekutif dan Koordinasi dengan Pemerintah Pusat dan Provinsi;0;661000000;0;661000000
4.01 . 4.01.09;SATUAN POLISI PAMONG PRAJA DAN PERLINDUNGAN MASYARAKAT;546000000;953617559;616000000;2115617559
4.01 . 4.01.09 . 01;Peningkatan Pelayanan Administrasi, Sarana dan Prasarana serta Sumber Daya Aparatur;546000000;743482951;616000000;1905482951
4.01 . 4.01.09 . 01 . 01;Pelayanan Jasa Administrasi Perkantoran;546000000;133733899;0;679733899
4.01 . 4.01.09 . 01 . 08;Peningkatan Sarana dan Prasarana Perkantoran;0;429596512;616000000;1045596512
4.01 . 4.01.09 . 01 . 15;Peningkatan Kapasitas SDM Aparatur;0;180152540;0;180152540
4.01 . 4.01.09 . 02;Program Peningkatan Perencanaan, Koordinasi, Monitoring Dan Evaluasi;0;210134608;0;210134608
4.01 . 4.01.09 . 02 . 26;Penyusunan Program, Anggaran dan Laporan Keuangan;0;110134608;0;110134608
4.01 . 4.01.09 . 02 . 27;Forum Koordinasi Kabupaten/Kota dan lintas Kementerian/Lembaga;0;100000000;0;100000000
04.02;Pengawasan;736050000;6475132000;263750000;7474932000
4.02 . 4.02.01;INSPEKTORAT PROVINSI GORONTALO;736050000;6475132000;263750000;7474932000
4.02 . 4.02.01 . 01;Program Pelayanan Administrasi, Sarana Prasarana dan SDM Aparatur;164040000;1803362000;263750000;2231152000
4.02 . 4.02.01 . 01 . 01;Pelayanan Jasa Administrasi Perkantoran;164040000;552362000;0;716402000
4.02 . 4.02.01 . 01 . 08;Peningkatan Sarana dan Prasarana Perkantoran;0;402270000;263750000;666020000
4.02 . 4.02.01 . 01 . 15;Peningkatan Kapasitas SDM Aparatur;0;848730000;0;848730000
4.02 . 4.02.01 . 02;Program Perencanaan, Evaluasi, Monitoring dan Pelaporan;60720000;373060000;0;433780000
4.02 . 4.02.01 . 02 . 01;Penyusunan Rencana Program, Data, Monitoring dan Evaluasi Pelaporan;60720000;266206000;0;326926000
4.02 . 4.02.01 . 02 . 02;Penatausahaan dan Penyusunan Laporan Keuangan;0;106854000;0;106854000
4.02 . 4.02.01 . 17;Program Pencegahan  dan Pemberantasan Korupsi;243330000;1291670000;0;1535000000
4.02 . 4.02.01 . 17 . 01;Rencana Aksi Daerah Pemberantasan dan Pencegahan Korupsi;28050000;321950000;0;350000000
4.02 . 4.02.01 . 17 . 02;Saber Pungli;184920000;215080000;0;400000000
4.02 . 4.02.01 . 17 . 03;Penerapan SPIP untuk Pemerintah Provinsi;30360000;319640000;0;350000000
4.02 . 4.02.01 . 17 . 04;Koordinasi Pengawasan Tingkat Provinsi, Regional dan Nasional;0;435000000;0;435000000
4.02 . 4.02.01 . 18;Program Pengawasan Atas Akuntabilitas Kinerja dan Keuangan;267960000;3007040000;0;3275000000
4.02 . 4.02.01 . 18 . 01;Audit Pengelolaan Barang dan Jasa, SDM dan Pengeloaan Keuangan;0;950000000;0;950000000
4.02 . 4.02.01 . 18 . 02;Pemeriksaan atas sekolah menegah dan khsusus (SLB);0;300000000;0;300000000
4.02 . 4.02.01 . 18 . 03;Pengawasan Perencanaan dan Pelaporan;96360000;403640000;0;500000000
4.02 . 4.02.01 . 18 . 04;Tindak Lanjut atas Rekomendasi Hasil Pengawasan;116160000;308840000;0;425000000
4.02 . 4.02.01 . 18 . 05;Pengawasan Kabupaten/Kota;27720000;422280000;0;450000000
4.02 . 4.02.01 . 18 . 06;Evaluasi Pelaksanaan Reformasi Birokrasi, Zona Integritas dan Pelayanan Publik;0;200000000;0;200000000
4.02 . 4.02.01 . 18 . 07;Penanganan Kasus Pengaduan, Permintaan  dan Pemeriksaan Startegis Lainnya di Lingkungan Pemerintah Daerah;27720000;422280000;0;450000000
04.03;Perencanaan;1216800000;8775026000;733950000;10725776000
4.03 . 4.03.01;BADAN PERENCANAAN, PENELITIAN DAN PENGEMBANGAN DAERAH;1216800000;8775026000;733950000;10725776000
4.03 . 4.03.01 . 01;Program Peningkatan Manajemen Administrasi, Sarana dan Prasarana serta Sumber Daya Aparatur;528480000;1752578000;733950000;3015008000
4.03 . 4.03.01 . 01 . 01;Pelayanan Jasa Administrasi Perkantoran;528480000;574472000;0;1102952000
4.03 . 4.03.01 . 01 . 02;Peningkatan Sarana dan Prasarana Perkantoran;0;878106000;733950000;1612056000
4.03 . 4.03.01 . 01 . 03;Peningkatan Kapasitas Sumber Daya Aparatur (Pendidikan dan Pelatihan, Bimbingan Teknis dan Sosialisasi);0;300000000;0;300000000
4.03 . 4.03.01 . 02;Program Perencanaan, Monitoring, Evaluasi dan Pelaporan;0;1366588000;0;1366588000
4.03 . 4.03.01 . 02 . 01;Penatausahaan dan Penyusunan Laporan Keuangan;0;125000000;0;125000000
4.03 . 4.03.01 . 02 . 02;Peningkatan Koordinasi Kabupaten/Kota dan Lintas Kementerian/Lembaga;0;1241588000;0;1241588000
4.03 . 4.03.01 . 21;Program Perencanaan Pembangunan Daerah;624960000;4654220000;0;5279180000
4.03 . 4.03.01 . 21 . 01;Penyusunan Dokumen Evaluasi dan Laporan Pelaksanaan Pembangunan Daerah;33120000;261880000;0;295000000
4.03 . 4.03.01 . 21 . 02;Pengendalian dan Evaluasi Dokumen Rencana Pembangunan Daerah;33120000;301880000;0;335000000
4.03 . 4.03.01 . 21 . 03;Perencanaan Pembangunan Daerah;66240000;668760000;0;735000000
4.03 . 4.03.01 . 21 . 04;Koordinasi Perencanaan Pembangunan Sektor Pertanian dan Pangan;31680000;338320000;0;370000000
4.03 . 4.03.01 . 21 . 05;Koordinasi Perencanaan Pembangunan Sektor Dunia Usaha dan Industri;33120000;401880000;0;435000000
4.03 . 4.03.01 . 21 . 06;Koordinasi Perencanaan Pembangunan Sektor Kelautan, Perikanan dan Pariwisata;33120000;306880000;0;340000000
4.03 . 4.03.01 . 21 . 07;Koordinasi Perencanaan Pembangunan Bidang Kesehatan dan Kesejahteraan Sosial;99360000;484820000;0;584180000
4.03 . 4.03.01 . 21 . 08;Koordinasi Perencanaan Pembangunan Bidang Pemerintahan, Kependudukan dan Revolusi Mental;66240000;513760000;0;580000000
4.03 . 4.03.01 . 21 . 09;Koordinasi Perencanaan Pembangunan Bidang Pendidikan, Agama, Pemuda dan Kebudayaan;63360000;316640000;0;380000000
4.03 . 4.03.01 . 21 . 10;Koordinasi Perencanaan Pembangunan Sektor Prasarana Ke-Ciptakaryaan, Perumahan dan Kawasan Permukiman.;66240000;328760000;0;395000000
4.03 . 4.03.01 . 21 . 11;Koordinasi Perencanaan Pembangunan Sektor Lingkungan Hidup, Kehutanan dan Prasarana Sumber Daya Air;33120000;346880000;0;380000000
4.03 . 4.03.01 . 21 . 12;Koordinasi Perencanaan Pembangunan Sektor Tata Ruang dan Prasarana Perhubungan;66240000;383760000;0;450000000
4.03 . 4.03.01 . 29;Program Pengembangan Riset Daerah;63360000;1001640000;0;1065000000
4.03 . 4.03.01 . 29 . 01;Penelitian dan Pengembangan Bidang Prasarana Wilayah;30240000;369760000;0;400000000
4.03 . 4.03.01 . 29 . 02;Penelitian dan Pengembangan Bidang Sosial Budaya;33120000;325880000;0;359000000
4.03 . 4.03.01 . 29 . 03;Penelitian dan Pengembangan Bidang Ekonomi dan Pembangunan;0;306000000;0;306000000
04.04;Keuangan;2467760000;10481217004;437000000;13385977004
4.04 . 4.04.05;BADAN KEUANGAN PROVINSI GORONTALO;2467760000;10481217004;437000000;13385977004
4.04 . 4.04.05 . 01;Program Pelayanan Administrasi, Sarana dan Prasarana serta SDM Aparatur;0;2834871621;437000000;3271871621
4.04 . 4.04.05 . 01 . 01;Pelayanan Jasa Administrasi Perkantoran;0;545049931;0;545049931
4.04 . 4.04.05 . 01 . 08;Peningkatan Sarana dan Prasarana Perkantoran;0;459083090;437000000;896083090
4.04 . 4.04.05 . 01 . 21;Peningkatan Kapasitas Sumber Daya Aparatur Keuangan Daerah;0;283110000;0;283110000
4.04 . 4.04.05 . 01 . 23;Pelayanan Jasa Administrasi/ Sarana dan Prasarana Perkantoran (UPTD Wilayah I);0;593450000;0;593450000
4.04 . 4.04.05 . 01 . 24;Pelayanan Jasa Administrasi/ Sarana dan Prasarana Perkantoran (UPTD Wilayah II);0;541784000;0;541784000
4.04 . 4.04.05 . 01 . 25;Pelayanan Jasa Administrasi/ Sarana dan Prasarana Perkantoran (UPTD Wilayah III);0;412394600;0;412394600
4.04 . 4.04.05 . 02;Program Perencanaan, Monitoring, Evaluasi Dan Pelaporan;308880000;567634861;0;876514861
4.04 . 4.04.05 . 02 . 01;Perencanaan, Koordinasi, Monitoring dan Evaluasi;0;373849861;0;373849861
4.04 . 4.04.05 . 02 . 02;Penatausahaan dan Penyusunan Laporan Keuangan;0;100000000;0;100000000
4.04 . 4.04.05 . 02 . 03;Pengelolaan Data dan Pengembangan Teknologi Informasi (PDE);308880000;93785000;0;402665000
4.04 . 4.04.05 . 03;Program Peningkatan dan Pengembangan Pengelolaan Keuangan Daerah;587160000;3583853522;0;4171013522
4.04 . 4.04.05 . 03 . 01;Penyusunan Rancangan Peraturan Daerah Tentang APBD dan Penyusunan Rancangan Peraturan KDH Tentang Penjabaran APBD (induk);0;451000000;0;451000000
4.04 . 4.04.05 . 03 . 02;Penyusunan Rancangan Peraturan Daerah Tentang Perubahan APBD dan Penyusunan Rancangan Peraturan KDH Tentang Penjabaran Perubahan APBD;0;111000000;0;111000000
4.04 . 4.04.05 . 03 . 03;Penyusunan Rancangan Peraturan Daerah Tentang Pertanggungjawaban Pelaksanaan APBD dan Penyusunan Rancangan Peraturan KDH Tentang Penjabaran Pertanggungjawaban Pelaksanaan APBD;27720000;273640000;0;301360000
4.04 . 4.04.05 . 03 . 04;Pengembangan Sistem Informasi Manajemen Keuangan Daerah;149160000;388180000;0;537340000
4.04 . 4.04.05 . 03 . 05;Pelayanan Arus Kas dan Penyediaan SPD;88440000;46200000;0;134640000
4.04 . 4.04.05 . 03 . 06;Penyusunan Kebijakan Keuangan Daerah;0;170000000;0;170000000
4.04 . 4.04.05 . 03 . 07;Penyusunan Buku Standarisasi Barang dan Jasa;124200000;93910000;0;218110000
4.04 . 4.04.05 . 03 . 08;Penatausahaan Aset;0;767183522;0;767183522
4.04 . 4.04.05 . 03 . 09;Penatausahaan APBD;27720000;228100000;0;255820000
4.04 . 4.04.05 . 03 . 10;Pelayanan Perbendaharaan;27720000;124440000;0;152160000
4.04 . 4.04.05 . 03 . 11;Penyempurnaan Sisdur Penatausahaan Keuangan Daerah;0;115000000;0;115000000
4.04 . 4.04.05 . 03 . 12;Pembinaan Akuntansi dan Laporan Keuangan SKPD;30360000;196480000;0;226840000
4.04 . 4.04.05 . 03 . 13;Kebijakan dan Pengendalian Aset;82800000;448720000;0;531520000
4.04 . 4.04.05 . 03 . 14;Penyusunan Dan Sosialisasi Paket Regulasi Akuntansi;29040000;170000000;0;199040000
4.04 . 4.04.05 . 04;Program Pembinaan Dan Fasilitasi Pengelolaan Keuangan Kabupaten/Kota;0;120565000;0;120565000
4.04 . 4.04.05 . 04 . 01;Evaluasi Rancangan Peraturan Daerah Tentang APBD dan Rancangan Peraturan KDH Tentang Penjabaran APBD Kabupaten/Kota;0;120565000;0;120565000
4.04 . 4.04.05 . 05;Program Intensifikasi dan Ekstensifikasi Sumber - sumber Pendapatan Daerah;1571720000;3374292000;0;4946012000
4.04 . 4.04.05 . 05 . 04;Monitoring, Evaluasi, Pendapatan Daerah;0;200000000;0;200000000
4.04 . 4.04.05 . 05 . 05;Koordinasi Pajak;0;121000000;0;121000000
4.04 . 4.04.05 . 05 . 06;Koordinasi dan Monitoring Evaluasi Samsat;346640000;187840000;0;534480000
4.04 . 4.04.05 . 05 . 07;Penyusunan Nilai Jual Kendaraan Bermotor (NJKB);0;220000000;0;220000000
4.04 . 4.04.05 . 05 . 08;Intensifikasi Sumber-sumber Pendapatan Daerah (UPTD Wilayah I);507600000;453350000;0;960950000
4.04 . 4.04.05 . 05 . 09;Intensifikasi Sumber-sumber Pendapatan Daerah (UPTD Wilayah II);401760000;532540000;0;934300000
4.04 . 4.04.05 . 05 . 10;Intensifikasi Sumber-sumber Pendapatan Daerah (UPTD Wilayah III);315720000;458480000;0;774200000
4.04 . 4.04.05 . 05 . 11;Ekstensifikasi Sumber-sumber Pendapatan Daerah;0;1201082000;0;1201082000
04.05;Kepegawaian;530640000;5087818000;580200000;6198658000
4.05 . 4.05.07;BADAN KEPEGAWAIAN;530640000;5087818000;580200000;6198658000
4.05 . 4.05.07 . 01;Program Pelayanan Administrasi, Sarana Prasarana dan SDM Aparatur;174240000;876633000;580200000;1631073000
4.05 . 4.05.07 . 01 . 23;Pelayanan Jasa Administrasi Perkantoran (Badan Kepegawaian Daerah);174240000;438660000;0;612900000
4.05 . 4.05.07 . 01 . 24;Peningkatan Sarana dan Prasarana Perkantoran (Badan Kepegawaian Daerah);0;376073000;580200000;956273000
4.05 . 4.05.07 . 01 . 25;Peningkatan Kapasitas Sumber Daya Aparatur  (Badan Kepegawaian Daerah);0;61900000;0;61900000
4.05 . 4.05.07 . 02;Program Perencanaan, Evaluasi dan Pelaporan;58080000;496568000;0;554648000
4.05 . 4.05.07 . 02 . 02;Perencanaan, Koordinasi, Monitoring dan Evaluasi;0;404648000;0;404648000
4.05 . 4.05.07 . 02 . 20;Penatausahaan dan Penyusunan Laporan Keuangan;58080000;91920000;0;150000000
4.05 . 4.05.07 . 15;Program Pengembangan Aparatur;60720000;1866040000;0;1926760000
4.05 . 4.05.07 . 15 . 02;Pemberian Bantuan Studi Tugas Belajar dan Izin Belajar ASN Pemprov Gorontalo;0;615000000;0;615000000
4.05 . 4.05.07 . 15 . 03;Penyelenggaraan Seleksi Penerimaan Calon Praja IPDN;0;437925000;0;437925000
4.05 . 4.05.07 . 15 . 04;Penyusunan Dokumen Analisis Kebutuhan Pegawai dan Formasi;30360000;44640000;0;75000000
4.05 . 4.05.07 . 15 . 05;Pelaksanaan Ujian Dinas, Ujian Penyesuaian Kenaikan Pangkat dan Ujian Peningkatan Pendidikan;30360000;192340000;0;222700000
4.05 . 4.05.07 . 15 . 06;Pelaksanaan Seleksi Jabatan Struktural;0;300000000;0;300000000
4.05 . 4.05.07 . 15 . 07;Pelaksanaan Uji Kompetensi ASN;0;210585000;0;210585000
4.05 . 4.05.07 . 15 . 08;Peyusunan Standar Kompetensi Jabatan ASN Provinsi Gorontalo;0;65550000;0;65550000
4.05 . 4.05.07 . 16;Program Peningkatan Kesejahteraan dan Pembinaan Aparatur;85800000;937796000;0;1023596000
4.05 . 4.05.07 . 16 . 01;Pelayanan Kesejahteraan Pegawai;30360000;169570000;0;199930000
4.05 . 4.05.07 . 16 . 02;Pembinaan dan Penanganan Kasus-kasus Disiplin;0;146000000;0;146000000
4.05 . 4.05.07 . 16 . 04;Pembinaan Fisik, Mental dan Spritual Anggota KORPRI;27720000;429446000;0;457166000
4.05 . 4.05.07 . 16 . 05;Pelaksanaan Pekan Olahraga Korpri tingkat SKPD Provinsi Gorontalo;27720000;109420000;0;137140000
4.05 . 4.05.07 . 16 . 06;Pembekalan ASN Purna Bakti dan Tata Upacara Persemayaman;0;83360000;0;83360000
4.05 . 4.05.07 . 17;Program Peningkatan Kualitas Pelayanan Manajemen PNS;151800000;910781000;0;1062581000
4.05 . 4.05.07 . 17 . 01;Pelayanan Kenaikan Pangkat, dan Pensiun ASN;30360000;238940000;0;269300000
4.05 . 4.05.07 . 17 . 02;Pengangkatan dalam Jabatan JPT,Administrator,Pegawas dan Fungsional;60720000;262280000;0;323000000
4.05 . 4.05.07 . 17 . 03;Pelayanan Mutasi PNS;0;85675000;0;85675000
4.05 . 4.05.07 . 17 . 04;Pengelolaan data dan pengembangan sistem pelayanan manajemen PNS;30360000;135360000;0;165720000
4.05 . 4.05.07 . 17 . 05;Manajemen Arsip Kepegawaian Daerah;30360000;188526000;0;218886000
04.06;Pendidikan dan Pelatihan;570000000;6637193000;784214000;7991407000
4.06 . 4.06.10;BADAN PENDIDIKAN DAN PELATIHAN;570000000;6637193000;784214000;7991407000
4.06 . 4.06.10 . 01;Program Pelayanan Administrasi, Sarana Prasarana dan SDM Aparatur;210120000;1999996000;784214000;2994330000
4.06 . 4.06.10 . 01 . 01;Pelayanan Jasa Adminsitrasi Perkantoran;210120000;627960000;0;838080000
4.06 . 4.06.10 . 01 . 02;Peningkatan Sarana dan Prasarana Perkantoran;0;315786000;784214000;1100000000
4.06 . 4.06.10 . 01 . 03;Peningkatan Kapasitas Sumber Daya Manusia Aparatur;0;706250000;0;706250000
4.06 . 4.06.10 . 01 . 04;Pengembangan Kapasitas Widyaiswara / Fasilitator;0;350000000;0;350000000
4.06 . 4.06.10 . 02;Program Perencanaan, Evaluasi, Monitoring, dan Pelaporan;58080000;441920000;0;500000000
4.06 . 4.06.10 . 02 . 01;Perencanaan, Koordinasi, Monitoring, Evaluasi dan Pelaporan;30360000;369640000;0;400000000
4.06 . 4.06.10 . 02 . 02;Penatausahaan dan Penyusunan Laporan Keuangan;27720000;72280000;0;100000000
4.06 . 4.06.10 . 15;Program Pengembangan Kompetensi Manajerial;183000000;3139077000;0;3322077000
4.06 . 4.06.10 . 15 . 01;Diklat Kepemimpinan Tingkat IV;36360000;813640000;0;850000000
4.06 . 4.06.10 . 15 . 03;Diklat Kepemimpinan Tingkat I, II dan LEMHANAS;60720000;299640000;0;360360000
4.06 . 4.06.10 . 15 . 04;Diklat Prajabatan/Pelatihan Dasar CPNS;85920000;2025797000;0;2111717000
4.06 . 4.06.10 . 16;Program Pengembangan Aplikasi, SIstem Informasi dan Jurnal Ilmiah Kediklatan;0;150000000;0;150000000
4.06 . 4.06.10 . 16 . 01;Pembangunan/Pengembangan Sistem Informasi Kediklatan;0;150000000;0;150000000
4.06 . 4.06.10 . 17;Program Peningkatan Kompetensi Teknis dan Fungsional Aparatur;58080000;441920000;0;500000000
4.06 . 4.06.10 . 17 . 01;Diklat Teknis;30360000;369640000;0;400000000
4.06 . 4.06.10 . 17 . 02;Diklat Fungsional;27720000;72280000;0;100000000
4.06 . 4.06.10 . 18;Program Pengembangan Kapasitas, Mutu dan Kerja Sama Kediklatan;60720000;464280000;0;525000000
4.06 . 4.06.10 . 18 . 01;Fasilitasi dan Kerjasama Penyelenggaraan Diklat;30360000;169640000;0;200000000
4.06 . 4.06.10 . 18 . 03;Penyusunan Dokumen Analisis Kebutuhan Diklat;30360000;119640000;0;150000000
4.06 . 4.06.10 . 18 . 04;Penjaminan Mutu, Pemeliharaan dan Peningkatan Akreditasi Lembaga  Diklat;0;100000000;0;100000000
4.06 . 4.06.10 . 18 . 05;Penyusunan Rancang Bangun Program Diklat;0;75000000;0;75000000
